an	DT	an
overnight	JJ	overnight
Israelis	NPS	Israelis
strike	VVP	strike
on	IN	on
an	DT	an
apartment	NN	apartment
Block	NN	block
in	IN	in
dead	JJ	dead
Al	NP	Al
Bala	NP	Bala
in	IN	in
central	JJ	central
Gaza	NP	Gaza
leaving	VVG	leave
some	DT	some
residents	NNS	resident
dead	JJ	dead
or	CC	or
wounded	VVN	wound
there	RB	there
'	''	'
s	NNS	s
too	RB	too
much	JJ	much
debris	NN	debris
for	IN	for
Rescuers	NNS	rescuer
to	TO	to
move	VV	move
by	IN	by
hand	NN	hand
so	IN	so
a	DT	a
bulldozzer	NN	bulldozzer
is	VBZ	be
put	VVN	put
to	TO	to
work	VV	work
scraping	VVG	scrape
open	RP	open
an	DT	an
entrance	NN	entrance
where	WRB	where
the	DT	the
search	NN	search
for	IN	for
survivors	NNS	survivor
can	MD	can
begin	VV	begin
after	IN	after
some	DT	some
time	NN	time
they	PP	they
think	VVP	think
they	PP	they
found	VVD	find
a	DT	a
young	JJ	young
boy	NN	boy
alive	JJ	alive
but	CC	but
it	PP	it
'	POS	'
s	VVN	s
too	RB	too
[	SYM	[
Music	NN	music
]	SYM	]
late	RB	late
then	RB	then
a	DT	a
young	JJ	young
girl	NN	girl
emerges	VVZ	emerge
what	WP	what
'	POS	'
s	VVG	s
your	PP$	your
name	NN	name
he	PP	he
asks	VVZ	ask
then	RB	then
a	DT	a
second	JJ	second
alhamdulillah	NN	alhamdulillah
alhamd	NNS	alhamd
further	RBR	further
painstaking	JJ	painstaking
work	NN	work
uncovers	VVZ	uncover
several	JJ	several
more	JJR	more
bodies	NNS	body
among	IN	among
the	DT	the
ruins	NNS	ruin
entire	JJ	entire
families	NNS	family
killed	VVN	kill
as	IN	as
they	PP	they
slept	VVD	sleep
m	NN	m
lapple	JJ	lapple
al	NP	al
jazer	NN	jazer
