we	PP	we
turn	VVP	turn
now	RB	now
to	TO	to
some	DT	some
breaking	VVG	break
news	NN	news
an	DT	an
Israeli	JJ	Israeli
air	NN	air
strike	NN	strike
in	IN	in
southern	JJ	southern
Lebanon	NP	Lebanon
has	VHZ	have
killed	VVN	kill
at	IN	at
least	JJS	least
one	CD	one
person	NN	person
the	DT	the
attack	NN	attack
targeted	VVD	target
a	DT	a
residential	JJ	residential
building	NN	building
in	IN	in
the	DT	the
town	NN	town
of	IN	of
J	NP	J
janata	NNS	janata
near	IN	near
Ty	JJ	Ty
several	JJ	several
people	NNS	people
were	VBD	be
injured	VVN	injure
in	IN	in
the	DT	the
strike	NN	strike
earlier	RBR	earlier
on	IN	on
