in	IN	in
an	DT	an
instant	NN	instant
a	DT	a
fragile	JJ	fragile
semblance	NN	semblance
of	IN	of
calm	JJ	calm
and	CC	and
normaly	RB	normaly
for	IN	for
Palestinians	NPS	Palestinians
turns	VVZ	turn
to	TO	to
chaos	NN	chaos
an	DT	an
Israeli	JJ	Israeli
air	NN	air
strike	NN	strike
hits	VVZ	hit
a	DT	a
school	NN	school
housing	NN	housing
displaced	VVD	displace
Palestinians	NNS	Palestinian
in	IN	in
the	DT	the
town	NN	town
of	IN	of
abasan	NN	abasan
just	RB	just
east	RB	east
of	IN	of
con	JJ	con
yunus	NN	yunus
in	IN	in
southern	JJ	southern
Gaza	NP	Gaza
we	PP	we
were	VBD	be
sitting	VVG	sit
in	IN	in
a	DT	a
missile	NN	missile
fell	VVD	fall
and	CC	and
destroyed	VVD	destroy
everything	NN	everything
I	PP	I
lost	VVD	lose
my	PP$	my
uncle	NN	uncle
my	PP$	my
cousins	NNS	cousin
and	CC	and
my	PP$	my
relatives	NNS	relative
Vehicles	NNS	vehicle
covered	VVN	cover
in	IN	in
blood	NN	blood
quickly	RB	quickly
usher	NN	usher
in	IN	in
the	DT	the
injured	JJ	injured
and	CC	and
the	DT	the
deceased	NN	deceased
to	TO	to
nearby	JJ	nearby
Nasser	NP	Nasser
[	SYM	[
Music	NP	Music
]	SYM	]
hospital	NN	hospital
hospital	NN	hospital
beds	NNS	bed
are	VBP	be
a	DT	a
luxury	NN	luxury
in	IN	in
Gaza	NP	Gaza
as	IN	as
most	JJS	most
patients	NNS	patient
are	VBP	be
tended	VVN	tend
to	TO	to
on	IN	on
the	DT	the
floor	NN	floor
where	WRB	where
they	PP	they
lay	VVD	lie
the	DT	the
Palestinian	JJ	Palestinian
Health	NP	Health
Ministry	NP	Ministry
says	VVZ	say
Israel	NP	Israel
'	POS	'
s	NN	S
military	NN	military
targeted	VVD	target
six	CD	six
other	JJ	other
displacement	NN	displacement
camps	NNS	camp
throughout	IN	throughout
the	DT	the
besieged	JJ	besieged
strip	NN	strip
making	VVG	make
this	DT	this
one	CD	one
of	IN	of
the	DT	the
deadliest	JJS	deadly
days	NNS	day
in	IN	in
recent	JJ	recent
weeks	NNS	week
[	SYM	[
Applause	NN	applause
]	SYM	]
the	DT	the
attacks	NNS	attack
come	VVP	come
on	IN	on
the	DT	the
backdrop	NN	backdrop
of	IN	of
renewed	JJ	renewed
ceasefire	NN	ceasefire
talks	NNS	talk
in	IN	in
Qatar	NP	Qatar
on	IN	on
Wednesday	NP	Wednesday
the	DT	the
CIA	NP	CIA
Chief	NP	Chief
as	RB	as
well	RB	well
as	IN	as
the	DT	the
head	NN	head
of	IN	of
Israel	NP	Israel
'	POS	'
s	JJ	s
intelligence	NN	intelligence
agency	NN	agency
mosad	NN	mosad
are	VBP	be
expected	VVN	expect
to	TO	to
attend	VV	attend
with	IN	with
Israel	NP	Israel
'	POS	'
s	JJ	s
war	NN	war
on	IN	on
Gaza	NP	Gaza
entering	VVG	enter
its	PP$	its
9th	JJ	9th
month	NN	month
any	DT	any
excitement	NN	excitement
about	IN	about
those	DT	those
talks	NNS	talk
remains	VVZ	remain
mute	JJ	mute
for	IN	for
many	JJ	many
Palestinians	NNS	Palestinian
for	IN	for
most	JJS	most
people	NNS	people
in	IN	in
the	DT	the
strip	NN	strip
are	VBP	be
just	RB	just
trying	VVG	try
to	TO	to
survive	VV	survive
another	DT	another
dayr	NP	dayr
Lan	NP	Lan
Al	NP	Al
jazer	NN	jazer
make	VVP	make
sure	JJ	sure
to	TO	to
subscribe	VV	subscribe
to	TO	to
our	PP$	our
channel	NN	channel
to	TO	to
get	VV	get
the	DT	the
latest	JJS	late
news	NN	news
from	IN	from
Al	NP	Al
jaaz	NP	jaaz
