كان	JJ	كان
المتحدث	JJ	المتحدث
في	NN	في
قمة	NN	قمة
القاهرة	NN	القاهرة
للسلام	NN	للسلام
هو	NN	هو
الأمين	NN	الأمين
العام	NN	العام
للأمم	NN	للأمم
المتحدة	NNS	المتحدة
أنطونيو	JJ	أنطونيو
جويتس	NP	جويتس
تحدث	NN	تحدث
عن	NN	عن
زيارته	NN	زيارته
إلى	NN	إلى
معبر	JJ	معبر
رفح	NP	رفح
الحدودي	NN	الحدودي
ذهبت	NN	ذهبت
إلى	NN	إلى
معبر	JJ	معبر
رفح	NP	رفح
الحدودي	NN	الحدودي
هناك	NN	هناك
رأيت	NN	رأيت
مفارقة	NNS	مفارقة
:	:	:
كارثة	JJ	كارثة
إنسانية	NN	إنسانية
تحدث	NN	تحدث
في	NN	في
الوقت	NN	الوقت
الحقيقي	NN	الحقيقي
من	NN	من
ناحية	NN	ناحية
،	NN	،
رأيت	NN	رأيت
المئات	NN	المئات
من	NN	من
ومن	NN	ومن
ناحية	NN	ناحية
أخرى	NN	أخرى
،	NN	،
هناك	NN	هناك
شاحنات	NN	شاحنات
محملة	NN	محملة
بالأغذية	NN	بالأغذية
والإمدادات	NN	والإمدادات
الأساسية	NN	الأساسية
الأخرى	NN	الأخرى
،	NN	،
ونحن	NN	ونحن
نعلم	NN	نعلم
أنه	NN	أنه
على	NN	على
الجانب	NN	الجانب
الآخر	NN	الآخر
من	NN	من
الحدود	NN	الحدود
يوجد	NN	يوجد
مليوني	NN	مليوني
شخص	NN	شخص
بدون	NN	بدون
ماء	NP	ماء
وطعام	NP	وطعام
ووقود	NP	ووقود
وكهرباء	NP	وكهرباء
وأدوية	NN	وأدوية
وأطفال	NN	وأطفال
وأمهات	NN	وأمهات
وكبار	NN	وكبار
السن	NN	السن
ومرضى	NN	ومرضى
ومسارات	NN	ومسارات
ممتلئة	NN	ممتلئة
من	NN	من
جانب	NN	جانب
وبطون	NN	وبطون
فارغة	NN	فارغة
من	NN	من
الجانب	NN	الجانب
الآخر	NN	الآخر
.	SENT	.
