<video_id>tDrWM7THWF4</video_id>	NN	<video_id>tDrWM7THWF4</video_id>
<video_title>Displaced	VVD	<video_title>Displaced
in	IN	in
Gaza:	NP	Gaza:
Not	RB	not
enough	RB	enough
tents	VVZ	tent
for	IN	for
tens	NNS	ten
of	IN	of
thousands	NNS	thousand
families</video_title>	NN	families</video_title>
<thumbnail_path>data/en_AJ\Displaced	VVN	<thumbnail_path>data/en_AJ\Displaced
in	IN	in
Gaza	NP	Gaza
Not	RB	not
enough	RB	enough
tents	VVZ	tent
for	IN	for
tens	NNS	ten
of	IN	of
thousands	NNS	thousand
families.jpg</thumbnail_path>	JJ	families.jpg</thumbnail_path>
<publish_date>20231020</publish_date>	NN	<publish_date>20231020</publish_date>
<doc>	NN	<doc>
أخيرًا	NN	أخيرًا
مكان	NN	مكان
للراحة،	NN	للراحة،
لحظة	NN	لحظة
سلام	NN	سلام
نادرة	NN	نادرة
لهذه	NN	لهذه
الفتاة	NN	الفتاة
الصغيرة،	NN	الصغيرة،
واحدة	NN	واحدة
من	NN	من
أكثر	NN	أكثر
من	NN	من
مليون	NN	مليون
فلسطيني	NN	فلسطيني
أُجبروا	NN	أُجبروا
على	NN	على
ترك	NN	ترك
منازلهم	NN	منازلهم
بينما	NN	بينما
تقصف	NN	تقصف
إسرائيل	NN	إسرائيل
قطاع	NN	قطاع
غزة،	NN	غزة،
وقد	NN	وقد
وجدت	NN	وجدت
بعض	NN	بعض
العائلات	NN	العائلات
مأوى	NN	مأوى
في	NN	في
مخيم	NN	مخيم
مؤقت	NN	مؤقت
في	NN	في
مدينة	NNS	مدينة
ك	JJ	ك
يونس	NP	يونس
هدات	NN	هدات
الجنوبية.	JJ	الجنوبية.
عندما	NN	عندما
أصاب	NN	أصاب
صاروخ	NN	صاروخ
إسرائيلي	NN	إسرائيلي
منزلها	NN	منزلها
كانت	NN	كانت
بداخله	NN	بداخله
عندما	NN	عندما
قُتلت	NN	قُتلت
إحدى	NN	إحدى
بناتها،	NN	بناتها،
انظر	NN	انظر
إلى	JJ	إلى
هؤلاء	NP	هؤلاء
الأطفال،	NN	الأطفال،
لقد	NN	لقد
أصيبوا	NN	أصيبوا
مثلي،	NN	مثلي،
لقد	NN	لقد
تم	NN	تم
انتشالنا	NN	انتشالنا
من	NN	من
تحت	NN	تحت
الأنقاض،	NN	الأنقاض،
كيف	NN	كيف
نخطئ،	NN	نخطئ،
لقد	NN	لقد
انهار	NN	انهار
منزلي	NN	منزلي
عليّ	NN	عليّ
أنا	NN	أنا
وبناتي	NN	وبناتي
و	NN	و
لقد	NN	لقد
جئنا	NN	جئنا
هنا	NN	هنا
لنعيش	NN	لنعيش
في	NN	في
خيام	NN	خيام
مذلة	NN	مذلة
ليس	NP	ليس
لدينا	NP	لدينا
ماء	NP	ماء
أو	JJ	أو
طعام	NN	طعام
أو	NN	أو
أي	NN	أي
شيء	NP	شيء
هربنا	NP	هربنا
فقط	NP	فقط
بالملابس	NP	بالملابس
التي	JJ	التي
كنا	NN	كنا
نرتديها،	NN	نرتديها،
أولئك	NN	أولئك
الذين	NN	الذين
لديهم	NN	لديهم
السقف	NN	السقف
فوق	NN	فوق
رؤوسهم	NN	رؤوسهم
هم	NN	هم
المحظوظون	NN	المحظوظون
الذين	NN	الذين
وضعتهم	NN	وضعتهم
وكالة	NN	وكالة
الأمم	NN	الأمم
المتحدة	NN	المتحدة
للإغاثة	NNS	للإغاثة
والتشغيل	JJ	والتشغيل
12010	CD	@card@
في	NN	في
ك	JJ	ك
يونيس	NP	يونيس
لكنها	NN	لكنها
ليست	NN	ليست
بالقوة	NN	بالقوة
الكافية	NN	الكافية
ولا	NN	ولا
توفر	NN	توفر
أي	NN	أي
حماية	NN	حماية
من	NN	من
الضربات	NN	الضربات
الجوية	NN	الجوية
المستمرة	NN	المستمرة
نحن	NN	نحن
الآن	NN	الآن
نعيش	NN	نعيش
مثل	NN	مثل
أجدادنا	NN	أجدادنا
عام	NN	عام
1948	CD	@card@
نزحوا	NN	نزحوا
من	NN	من
بيوتنا	NN	بيوتنا
مثلهم	NN	مثلهم
نعيش	NN	نعيش
في	NN	في
الخيام	NN	الخيام
يا	NN	يا
عالم	NN	عالم
ارحمنا	NN	ارحمنا
تعبنا	NN	تعبنا
نريد	NN	نريد
الهدنة	NN	الهدنة
ماذا	NN	ماذا
تريد	NN	تريد
إسرائيل	NN	إسرائيل
أن	NN	أن
نهجرنا	NN	نهجرنا
من	NN	من
منازلنا	NN	منازلنا
ماذا	NN	ماذا
يريدون	NN	يريدون
أكثر؟	NN	أكثر؟
إسرائيل	NN	إسرائيل
تنفذ	NN	تنفذ
أعنف	NN	أعنف
حملة	NN	حملة
قصف	NN	قصف
على	NN	على
الإطلاق	NN	الإطلاق
على	NN	على
غزة،	NN	غزة،
وهي	NN	وهي
حملة	NN	حملة
أكثر	NN	أكثر
كثافة	NN	كثافة
من	NN	من
أي	NN	أي
حروب	NN	حروب
سابقة.	JJ	سابقة.
جيشها	NN	جيشها
مصمم	NN	مصمم
على	NN	على
اجتثاث	NN	اجتثاث
مقاتلي	JJ	مقاتلي
حماس	NP	حماس
بعد	NN	بعد
أن	NN	أن
هاجمت	NN	هاجمت
الجماعة	NN	الجماعة
المسلحة	NN	المسلحة
جنوب	NN	جنوب
إسرائيل	NN	إسرائيل
2	CD	@card@
قبل	NN	قبل
أسابيع،	NN	أسابيع،
قتلت	NN	قتلت
1,400	CD	@card@
إسرائيلي،	NN	إسرائيلي،
وفرضت	NN	وفرضت
إسرائيل	NN	إسرائيل
أيضًا	NN	أيضًا
حصارًا	NN	حصارًا
شاملاً	NN	شاملاً
على	NN	على
غزة،	NN	غزة،
وقطعت	NN	وقطعت
واردات	NN	واردات
المياه	JJ	المياه
والغذاء	NP	والغذاء
والوقود،	NN	والوقود،
مما	NN	مما
أدى	NN	أدى
إلى	NN	إلى
تفاقم	NN	تفاقم
الأوضاع	NN	الأوضاع
في	NN	في
القطاع	NN	القطاع
المحاصر،	NN	المحاصر،
حيث	NN	حيث
يعتمد	NN	يعتمد
معظم	NN	معظم
السكان	NN	السكان
على	NN	على
المساعدات	NN	المساعدات
الإنسانية،	NN	الإنسانية،
وقد	NN	وقد
تعرضت	NN	تعرضت
مجمعات	NN	مجمعات
سكنية	NN	سكنية
بأكملها	NN	بأكملها
للقصف	NN	للقصف
مرتين	NN	مرتين
أو	NN	أو
ثلاث	NN	ثلاث
مرات.	JJ	مرات.
في	NN	في
كل	NN	كل
يوم،	NN	يوم،
تنهار	NN	تنهار
أربعة	NN	أربعة
أو	NN	أو
خمسة	NN	خمسة
منازل	NN	منازل
ويقتل	NN	ويقتل
ما	NN	ما
بين	NN	بين
40	CD	@card@
إلى	NN	إلى
50	CD	@card@
شخصًا	NN	شخصًا
في	NN	في
كل	NN	كل
مرة	NN	مرة
نغادر	NN	نغادر
فيها	NN	فيها
منازلنا	NN	منازلنا
ونذهب	NN	ونذهب
إلى	JJ	إلى
مدارس	NP	مدارس
الأمم	NN	الأمم
المتحدة	NN	المتحدة
حيث	NN	حيث
يتجمع	NN	يتجمع
آلاف	NN	آلاف
الأشخاص	NN	الأشخاص
في	NN	في
سبع	JJ	سبع
مدارس	NP	مدارس
وعيادة	NN	وعيادة
واحدة،	NN	واحدة،
لكن	NN	لكن
حتى	NN	حتى
تلك	JJ	تلك
المدارس	NP	المدارس
لم	NN	لم
تكن	NN	تكن
آمنة	NN	آمنة
قبل	NN	قبل
أسبوع.	JJ	أسبوع.
أصدر	NN	أصدر
الجيش	NN	الجيش
الإسرائيلي	NN	الإسرائيلي
أمر	JJ	أمر
إخلاء	NP	إخلاء
جماعي	NN	جماعي
لـ	NN	لـ
1.1	CD	@card@
مليون	NN	مليون
فلسطيني	NN	فلسطيني
يعيشون	NN	يعيشون
في	NN	في
شمال	NN	شمال
القطاع	NN	القطاع
قبل	NN	قبل
هجوم	NN	هجوم
بري	NN	بري
كبير،	NN	كبير،
لكن	NN	لكن
حتى	NN	حتى
في	NN	في
جنوب	NN	جنوب
قطاع	NN	قطاع
غزة،	NN	غزة،
حيث	NN	حيث
طلبت	NN	طلبت
السلطات	NN	السلطات
الإسرائيلية	NNS	الإسرائيلية
من	JJ	من
الناس	NP	الناس
الانتقال	NN	الانتقال
لحمايتهم،	NN	لحمايتهم،
فالوضع	JJ	فالوضع
ليس	NP	ليس
آمنًا،	NN	آمنًا،
موسوم	NN	موسوم
شريف	NN	شريف
الجازر.	JJ	الجازر.
تأكد	NN	تأكد
من	NN	من
الاشتراك	NN	الاشتراك
في	NN	في
قناتنا	NN	قناتنا
للحصول	NN	للحصول
على	NN	على
آخر	NN	آخر
الأخبار	NN	الأخبار
من	NN	من
الجزيرة	NN	الجزيرة
</doc>	NN	</doc>
