[	SYM	[
Music	NP	Music
]	SYM	]
The	DT	the
Israeli	JJ	Israeli
occupation	NN	occupation
planes	NNS	plane
targeted	VVD	target
a	DT	a
g	NN	g
We	PP	we
see	VVP	see
this	DT	this
blood	NN	blood
that	WDT	that
traces	VVZ	trace
bl	NN	bl
team	NN	team
came	VVD	come
rescue	NN	rescue
and	CC	and
volte	NN	volte
help	NN	help
param	NN	param
take	VV	take
vic	JJ	vic
hos	NN	hos
women	NNS	woman
were	VBD	be
also	RB	also
bombed	VVN	bomb
by	IN	by
the	DT	the
Israeli	JJ	Israeli
occupation	NN	occupation
Anas	NNS	ana
Al	NP	Al
-	NN	-
Sharif	NP	Sharif
Al	NP	Al
Jazeera	NP	Jazeera
,	,	,
