J	NP	J
is	VBZ	be
failing	VVG	fail
to	TO	to
honor	VV	honor
its	PP$	its
own	JJ	own
obligation	NN	obligation
to	TO	to
prevent	VV	prevent
genocide	NN	genocide
or	CC	or
to	TO	to
ensure	VV	ensure
respect	NN	respect
of	IN	of
international	JJ	international
humanitarian	JJ	humanitarian
law	NN	law
Nicaragua	NP	Nicaragua
is	VBZ	be
also	RB	also
requesting	VVG	request
the	DT	the
court	NN	court
to	TO	to
order	VV	order
that	DT	that
Germany	NP	Germany
to	TO	to
cease	VV	cease
providing	VVG	provide
support	NN	support
to	TO	to
Israel	NP	Israel
against	IN	against
campaign	NN	campaign
of	IN	of
destruction	NN	destruction
of	IN	of
the	DT	the
Palestinian	JJ	Palestinian
people	NNS	people
Germany	NP	Germany
cannot	MD	can
invoke	VV	invoke
that	IN/that	that
Israel	NP	Israel
is	VBZ	be
in	IN	in
some	DT	some
state	NN	state
of	IN	of
necessity	NN	necessity
of	IN	of
his	PP$	his
assistance	NN	assistance
for	IN	for
his	PP$	his
defense	NN	defense
and	CC	and
survival	NN	survival
in	IN	in
spite	NN	spite
of	IN	of
its	PP$	its
size	NN	size
and	CC	and
population	NN	population
Israel	NP	Israel
is	VBZ	be
on	IN	on
the	DT	the
top	JJ	top
10	CD	@card@
%	NN	%
of	IN	of
the	DT	the
most	RBS	most
militarily	RB	militarily
powerful	JJ	powerful
countries	NNS	country
in	IN	in
the	DT	the
world	NN	world
this	DT	this
per	FW	per
capita	NN	capita
expense	NN	expense
is	VBZ	be
more	JJR	more
than	IN	than
four	CD	four
times	NNS	time
larger	JJR	large
than	IN	than
that	DT	that
of	IN	of
Germany	NP	Germany
it	PP	it
is	VBZ	be
even	RB	even
higher	JJR	high
than	IN	than
that	DT	that
of	IN	of
the	DT	the
United	NP	United
States	NPS	States
German	JJ	German
companies	NNS	company
involved	VVN	involve
in	IN	in
the	DT	the
military	JJ	military
industry	NN	industry
are	VBP	be
directly	RB	directly
profiting	VVG	profit
from	IN	from
the	DT	the
situation	NN	situation
as	IN	as
they	PP	they
have	VHP	have
seen	VVN	see
their	PP$	their
share	NN	share
prices	NNS	price
rise	VVP	rise
since	IN	since
7	CD	@card@
October	NP	October
