Yemen	NP	Yemen
'	POS	'
s	JJ	s
houthi	NN	houthi
group	NN	group
has	VHZ	have
claimed	VVN	claim
responsibility	NN	responsibility
for	IN	for
a	DT	a
drone	NN	drone
attack	NN	attack
near	IN	near
the	DT	the
US	NP	US
Embassy	NP	Embassy
in	IN	in
Tel	NP	Tel
[	SYM	[
Music	NN	music
]	SYM	]
Aviv	NP	Aviv
one	CD	one
person	NN	person
was	VBD	be
killed	VVN	kill
and	CC	and
several	JJ	several
others	NNS	other
have	VHP	have
been	VBN	be
injured	VVN	injure
the	DT	the
houthi	NNS	houthi
say	VVP	say
they	PP	they
used	VVD	use
a	DT	a
new	JJ	new
type	NN	type
of	IN	of
drone	NN	drone
the	DT	the
Israeli	NP	Israeli
Army	NP	Army
says	VVZ	say
it	PP	it
entered	VVD	enter
the	DT	the
airspace	NN	airspace
without	IN	without
being	VBG	be
detected	VVN	detect
it	PP	it
'	POS	'
s	NN	S
now	RB	now
increasing	VVG	increase
air	NN	air
Patrols	NNS	patrol
