him	PP	him
in	IN	in
another	DT	another
room	NN	room
nurses	NNS	nurse
Comfort	NN	comfort
this	DT	this
little	RB	little
[	SYM	[
Music	NP	Music
]	SYM	]
floor	NN	floor
a	DT	a
reminder	NN	reminder
of	IN	of
the	DT	the
horrors	NNS	horror
of	IN	of
this	DT	this
war	NN	war
outside	IN	outside
this	DT	this
woman	NN	woman
cries	VVZ	cry
quietly	RB	quietly
a	DT	a
man	NN	man
can	MD	can
also	RB	also
be	VB	be
heard	VVN	hear
saying	VVG	say
the	DT	the
US	NP	US
and	CC	and
Israel	NP	Israel
are	VBP	be
to	TO	to
blame	VV	blame
I	PP	I
swear	VV	swear
to	TO	to
God	NP	God
my	PP$	my
heart	NN	heart
is	VBZ	be
in	IN	in
pain	NN	pain
she	PP	she
tells	VVZ	tell
them	PP	them
another	DT	another
Palestinian	NN	Palestinian
mentally	RB	mentally
broken	VVN	break
the	DT	the
injured	JJ	injured
and	CC	and
relatives	NNS	relative
of	IN	of
the	DT	the
Dead	NP	Dead
listen	NN	listen
to	TO	to
a	DT	a
man	NN	man
telling	VVG	tell
them	PP	them
to	TO	to
be	VB	be
prepared	VVN	prepare
to	TO	to
meet	VV	meet
their	PP$	their
maker	NN	maker
as	IN	as
death	NN	death
he	PP	he
says	VVZ	say
is	VBZ	be
on	IN	on
every	DT	every
corner	NN	corner
and	CC	and
every	DT	every
street	NN	street
this	DT	this
has	VHZ	have
become	VVN	become
an	DT	an
all	RB	all
too	RB	too
familiar	JJ	familiar
scene	NN	scene
across	IN	across
the	DT	the
Gaza	NP	Gaza
Strip	NP	Strip
despite	IN	despite
Israeli	JJ	Israeli
forces	NNS	force
withdrawing	VVG	withdraw
from	IN	from
several	JJ	several
areas	NNS	area
including	VVG	include
noat	NN	noat
refugee	NN	refugee
camp	NN	camp
a	DT	a
few	JJ	few
weeks	NNS	week
ago	RB	ago
they	PP	they
have	VHP	have
returned	VVN	return
with	IN	with
intense	JJ	intense
bombing	NN	bombing
under	IN	under
the	DT	the
guise	NN	guise
of	IN	of
defeating	VVG	defeat
Hamas	NNS	Hamas
most	JJS	most
Palestinians	NNS	Palestinian
in	IN	in
the	DT	the
North	NP	North
and	CC	and
the	DT	the
South	NP	South
aren	NN	aren
'	POS	'
t	NN	t
being	VBG	be
spared	VVN	spare
either	CC	either
nearly	RB	nearly
half	PDT	half
a	DT	a
million	CD	million
of	IN	of
them	PP	them
have	VHP	have
been	VBN	be
forced	VVN	force
to	TO	to
leave	VV	leave
Rafa	NP	Rafa
in	IN	in
just	RB	just
a	DT	a
matter	NN	matter
of	IN	of
days	NNS	day
another	DT	another
body	NN	body
wrapped	VVD	wrap
up	RP	up
in	IN	in
a	DT	a
sheet	NN	sheet
this	DT	this
is	VBZ	be
for	IN	for
ad	NN	ad
they	PP	they
say	VVP	say
he	PP	he
'	''	'
ll	NNS	ll
have	VHP	have
his	PP$	his
name	NN	name
written	VVN	write
on	IN	on
the	DT	the
white	JJ	white
cloth	NN	cloth
before	IN	before
being	VBG	be
buried	VVN	bury
for	IN	for
ad	NN	ad
is	VBZ	be
one	CD	one
of	IN	of
more	JJR	more
than	IN	than
35	CD	@card@
,	,	,
000	CD	@card@
Palestinians	NNS	Palestinian
killed	VVN	kill
since	IN	since
Israel	NP	Israel
launched	VVD	launch
its	PP$	its
war	NN	war
on	IN	on
Gaza	NP	Gaza
s	NN	S
Al	NP	Al
jaaz	NP	jaaz
make	VVP	make
sure	JJ	sure
to	TO	to
subscribe	VV	subscribe
to	TO	to
our	PP$	our
channel	NN	channel
to	TO	to
get	VV	get
the	DT	the
latest	JJS	late
news	NN	news
from	IN	from
Al	NP	Al
jazer	NP	jazer
