<video_id>GxaCmjsLeMk</video_id>	JJ	<video_id>GxaCmjsLeMk</video_id>
<video_title>Israeli	NN	<video_title>Israeli
bombardment	NN	bombardment
of	IN	of
Gaza:	NP	Gaza:
Government	NP	Government
media	NNS	medium
office	NN	office
calls	VVZ	call
for	IN	for
intervention</video_title>	JJ	intervention</video_title>
<thumbnail_path>data/en_AJ\Israeli	NN	<thumbnail_path>data/en_AJ\Israeli
bombardment	NN	bombardment
of	IN	of
Gaza	NP	Gaza
Government	NP	Government
media	NNS	medium
office	NN	office
calls	VVZ	call
for	IN	for
intervention.jpg</thumbnail_path>	JJ	intervention.jpg</thumbnail_path>
<publish_date>20231209</publish_date>	JJ	<publish_date>20231209</publish_date>
<doc>	NN	<doc>
in	IN	in
Rafa	NP	Rafa
the	DT	the
aid	NN	aid
trucks	NNS	truck
pass	VVP	pass
through	RP	through
but	CC	but
do	VVP	do
not	RB	not
often	RB	often
pause	VV	pause
the	DT	the
UN	NP	UN
is	VBZ	be
here	RB	here
but	CC	but
cannot	MD	can
always	RB	always
help	VV	help
and	CC	and
so	RB	so
with	IN	with
her	PP$	her
daughter	NN	daughter
lying	VVG	lie
sick	JJ	sick
man	NN	man
feels	VVZ	feel
[Music]	NN	[Music]
stuck	VVD	stick
my	PP$	my
husband	NN	husband
is	VBZ	be
missing	VVG	miss
I	PP	I
don't	VVD	don't
know	VV	know
anything	NN	anything
about	IN	about
him	PP	him
in	IN	in
Gaza	NP	Gaza
where	WRB	where
the	DT	the
communications	NNS	communication
are	VBP	be
down	RB	down
we	PP	we
don't	VVD	don't
have	VH	have
money	NN	money
to	TO	to
spend	VV	spend
or	CC	or
to	TO	to
eat	VV	eat
and	CC	and
nobody	NN	nobody
is	VBZ	be
helping	VVG	help
us	PP	us
the	DT	the
situation	NN	situation
is	VBZ	be
dangerous	JJ	dangerous
where	WRB	where
should	MD	should
we	PP	we
go	VV	go
smiles	NNS	smile
here	RB	here
are	VBP	be
still	RB	still
possible	JJ	possible
but	CC	but
with	IN	with
his	PP$	his
six	CD	six
young	JJ	young
children	NNS	child
now	RB	now
sitting	VVG	sit
in	IN	in
a	DT	a
single	JJ	single
tent	NN	tent
s	NN	S
Al	NP	Al
sakani	NP	sakani
wants	VVZ	want
the	DT	the
world	NN	world
to	TO	to
intervene	VV	intervene
we	PP	we
don't	NN	don't
want	VVP	want
war	NN	war
we're	NN	we're
tired	VVD	tire
we	PP	we
want	VVP	want
a	DT	a
decent	JJ	decent
life	NN	life
enough	RB	enough
how	WRB	how
many	JJ	many
family	NN	family
and	CC	and
friends	NNS	friend
have	VHP	have
we	PP	we
lost	VVN	lose
leaving	VVG	leave
the	DT	the
chaos	NN	chaos
of	IN	of
a	DT	a
carun	JJ	carun
hospital	NN	hospital
a	DT	a
tiny	JJ	tiny
baby	NN	baby
and	CC	and
a	DT	a
bandaged	VVN	bandage
child	NN	child
face	NN	face
engulfed	VVN	engulf
with	IN	with
dust	NN	dust
and	CC	and
despair	NN	despair
meanwhile	NN	meanwhile
gaza's	NN	gaza's
largest	JJS	large
most	RBS	most
historic	JJ	historic
MOS	NNS	mo
rendered	VVN	render
into	IN	into
Rubble	NN	rubble
by	IN	by
the	DT	the
bombing	NN	bombing
while	IN	while
spiraling	JJ	spiraling
smoke	NN	smoke
Smothers	NP	Smothers
the	DT	the
skyline	NN	skyline
the	DT	the
gunfire	NN	gunfire
goes	VVZ	go
on	RP	on
far	RB	far
above	IN	above
the	DT	the
aircraft	NN	aircraft
keeps	VVZ	keep
circling	VVG	circle
there	RB	there
is	VBZ	be
little	JJ	little
light	NN	light
left	VVN	leave
for	IN	for
those	DT	those
down	RB	down
below	IN	below
vill	NN	vill
marks	VVZ	mark
Al	NP	Al
make	VV	make
sure	JJ	sure
to	TO	to
subscribe	VV	subscribe
to	TO	to
our	PP$	our
channel	NN	channel
to	TO	to
get	VV	get
the	DT	the
latest	JJS	late
news	NN	news
from	IN	from
Al	NP	Al
</doc>	NP	</doc>
