today	NN	today
is	VBZ	be
tuesday	NN	Tuesday
which	WDT	which
is	VBZ	be
the	DT	the
first	JJ	first
day	NN	day
of	IN	of
the	DT	the
vaccination	NN	vaccination
camp	NN	camp
against	IN	against
the	DT	the
of	IN	of
the	DT	the
district	NN	district
the	DT	the
preparation	NN	preparation
here	RB	here
is	VBZ	be
under	IN	under
to	TO	to
vaccinate	VV	vaccinate
thousands	NNS	thousand
of	IN	of
children	NNS	child
below	IN	below
10	CD	@card@
years	NNS	year
via	IN	via
health	NN	health
centers	NNS	center
medical	JJ	medical
points	NNS	point
and	CC	and
medical	JJ	medical
teams	NNS	team
we	PP	we
are	VBP	be
currently	RB	currently
in	IN	in
front	NN	front
of	IN	of
the	DT	the
indonesian	JJ	Indonesian
hospital	NN	hospital
while	IN	while
families	NNS	family
are	VBP	be
flowing	VVG	flow
to	TO	to
vaccinate	VV	vaccinate
their	PP$	their
children	NNS	child
against	IN	against
mob	NN	mob
team	NN	team
Moaz	NP	Moaz
Al	NP	Al
-	NN	-
Kahlot	NP	Kahlot
Al	NP	Al
-	NP	-
Jazeera	NP	Jazeera
,	,	,
Jeb	NP	Jeb
Set	VVD	set
