<video_id>2il2B_pncHo</video_id>	JJ	<video_id>2il2B_pncHo</video_id>
<video_title>‘Horrible	JJ	<video_title>‘Horrible
massacre’	NN	massacre’
in	IN	in
Nuseirat	NP	Nuseirat
refugee	NN	refugee
camp	NN	camp
is	VBZ	be
evidence	NN	evidence
of	IN	of
‘genocide’:	JJ	‘genocide’:
Gov’t	NP	Gov’t
media	NNS	medium
office</video_title>	NN	office</video_title>
<thumbnail_path>data/en_AJ\‘Horrible	JJ	<thumbnail_path>data/en_AJ\‘Horrible
massacre’	NN	massacre’
in	IN	in
Nuseirat	NP	Nuseirat
refugee	NN	refugee
camp	NN	camp
is	VBZ	be
evidence	NN	evidence
of	IN	of
‘genocide’	JJ	‘genocide’
Gov’t	NP	Gov’t
media	NNS	medium
office.jpg</thumbnail_path>	NN	office.jpg</thumbnail_path>
<publish_date>20240606</publish_date>	NN	<publish_date>20240606</publish_date>
<doc>	NN	<doc>
this	DT	this
horrible	JJ	horrible
Massacre	NN	massacre
committed	VVN	commit
by	IN	by
the	DT	the
Israeli	JJ	Israeli
occupation	NN	occupation
is	VBZ	be
clear	JJ	clear
evidence	NN	evidence
of	IN	of
the	DT	the
crime	NN	crime
of	IN	of
genocide	NN	genocide
and	CC	and
ethnic	JJ	ethnic
cleansing	NN	cleansing
against	IN	against
civilians	NNS	civilian
including	VVG	include
women	NNS	woman
children	NNS	child
and	CC	and
displaced	VVN	displace
people	NNS	people
in	IN	in
the	DT	the
Gaza	NP	Gaza
Strip	NP	Strip
huge	JJ	huge
numbers	NNS	number
of	IN	of
deaths	NNS	death
and	CC	and
wounded	JJ	wounded
are	VBP	be
still	RB	still
arriving	VVG	arrive
into	IN	into
alaa	NN	alaa
Hospital	NN	hospital
which	WDT	which
has	VHZ	have
been	VBN	be
filled	VVN	fill
with	IN	with
Wounded	JJ	wounded
impatients	NNS	impatients
three	CD	three
times	NNS	time
Beyond	IN	beyond
its	PP$	its
clinical	JJ	clinical
capacity	NN	capacity
this	DT	this
portends	VVZ	portend
a	DT	a
real	JJ	real
disaster	NN	disaster
that	WDT	that
will	MD	will
lead	VV	lead
to	TO	to
an	DT	an
even	RB	even
greater	JJR	great
increase	NN	increase
in	IN	in
the	DT	the
number	NN	number
of	IN	of
Martyrs	NNS	martyr
</doc>	JJ	</doc>
