<video_id>F52yPm83bXU</video_id>	NP	<video_id>F52yPm83bXU</video_id>
<video_title>Israel	NP	<video_title>Israel
action	NN	action
in	IN	in
Gaza	NP	Gaza
'could	NP	'could
be	VB	be
war	NN	war
crimes'	NN	crimes'
says	VVZ	say
UN's	NP	UN's
Navi	NP	Navi
Pillay	NP	Pillay
-	NN	-
BBC	NP	BBC
News</video_title>	NP	News</video_title>
<thumbnail_path>data/en_BBCNews\Israel	NP	<thumbnail_path>data/en_BBCNews\Israel
action	NN	action
in	IN	in
Gaza	NP	Gaza
'could	NP	'could
be	VB	be
war	NN	war
crimes'	NN	crimes'
says	VVZ	say
UN's	NP	UN's
Navi	NP	Navi
Pillay	NP	Pillay
-	NN	-
BBC	NP	BBC
News.jpg</thumbnail_path>	NP	News.jpg</thumbnail_path>
<publish_date>20140723</publish_date>	NN	<publish_date>20140723</publish_date>
<doc>	NN	<doc>
my	PP$	my
staff	NN	staff
are	VBP	be
continuing	VVG	continue
to	TO	to
document	VV	document
several	JJ	several
other	JJ	other
cases	NNS	case
in	IN	in
which	WDT	which
family	NN	family
residences	NNS	residence
were	VBD	be
destroyed	VVN	destroy
with	IN	with
reported	VVN	report
loss	NN	loss
of	IN	of
civilian	JJ	civilian
life	NN	life
and	CC	and
in	IN	in
which	WDT	which
preliminary	JJ	preliminary
indication	NN	indication
suggest	VVP	suggest
not	RB	not
even	RB	even
a	DT	a
single	JJ	single
member	NN	member
of	IN	of
an	DT	an
armed	JJ	armed
group	NN	group
was	VBD	be
present	JJ	present
then	RB	then
just	RB	just
two	CD	two
days	NNS	day
ago	RB	ago
on	IN	on
21st	JJ	21st
July	NP	July
shells	NNS	shell
hit	VVD	hit
the	DT	the
AL	NP	al
AA	NN	aa
Hospital	NN	hospital
in	IN	in
dear	JJ	dear
albella	NNS	albella
reportedly	RB	reportedly
killing	VVG	kill
at	IN	at
least	JJS	least
three	CD	three
people	NNS	people
and	CC	and
wounded	JJ	wounded
dozens	NNS	dozen
of	IN	of
others	NNS	other
including	VVG	include
doctors	NNS	doctor
these	DT	these
are	VBP	be
just	RB	just
a	DT	a
few	JJ	few
instances	NNS	instance
where	WRB	where
there	EX	there
seems	VVZ	seem
to	TO	to
be	VB	be
a	DT	a
strong	JJ	strong
possibility	NN	possibility
that	IN/that	that
International	NP	International
humanit	NP	humanit
humanitarian	JJ	humanitarian
law	NN	law
has	VHZ	have
been	VBN	be
violated	VVN	violate
in	IN	in
a	DT	a
manner	NN	manner
that	WDT	that
could	MD	could
amount	VV	amount
to	TO	to
war	NN	war
crimes	NNS	crime
every	DT	every
one	CD	one
of	IN	of
these	DT	these
incidents	NNS	incident
must	MD	must
be	VB	be
properly	RB	properly
and	CC	and
independently	RB	independently
investigated	VVN	investigate
</doc>	NN	</doc>
