These	DT	these
provisional	JJ	provisional
measures	NNS	measure
of	IN	of
the	DT	the
ighs	NNS	ighs
are	VBP	be
binding	VVG	bind
and	CC	and
of	IN	of
course	NN	course
they	PP	they
must	MD	must
be	VB	be
followed	VVN	follow
.	SENT	.
We	PP	we
are	VBP	be
experiencing	VVG	experience
just	RB	just
the	DT	the
opposite	NN	opposite
and	CC	and
at	IN	at
the	DT	the
same	JJ	same
time	NN	time
we	PP	we
see	VVP	see
that	IN/that	that
it	PP	it
is	VBZ	be
not	RB	not
an	DT	an
advantage	NN	advantage
for	IN	for
Israel	NP	Israel
'	POS	'
s	JJ	s
security	NN	security
that	IN/that	that
no	DT	no
hostage	NN	hostage
is	VBZ	be
released	VVN	release
if	IN	if
people	NNS	people
are	VBP	be
now	RB	now
being	VBG	be
dumped	VVN	dump
in	IN	in
tents	NNS	tent
.	SENT	.
International	JJ	international
humanitarian	JJ	humanitarian
law	NN	law
applies	VVZ	apply
This	DT	this
also	RB	also
applies	VVZ	apply
to	TO	to
Israeli	JJ	Israeli
warfare	NN	warfare
