<video_id>BK-W8EjLCOk</video_id>	JJ	<video_id>BK-W8EjLCOk</video_id>
<video_title>Gaza	NN	<video_title>Gaza
cameraman	NN	cameraman
loses	VVZ	lose
family	NN	family
in	IN	in
airstrike	NP	airstrike
|	SYM	|
DW	JJ	DW
#Shorts	NNS	#Shorts
#Gaza	NN	#Gaza
#Israel</video_title>	NN	#Israel</video_title>
<thumbnail_path>en_DW\Gaza	NN	<thumbnail_path>en_DW\Gaza
cameraman	NN	cameraman
loses	VVZ	lose
family	NN	family
in	IN	in
airstrike	NN	airstrike
DW	NN	DW
#Shorts	NNS	#Shorts
#Gaza	NN	#Gaza
#Israel.jpg</thumbnail_path>	NN	#Israel.jpg</thumbnail_path>
<publish_date>20231106</publish_date>	NN	<publish_date>20231106</publish_date>
<doc>	NN	<doc>
[Music]	NN	[Music]
Today	NN	today
I	PP	I
lost	VVD	lose
all	PDT	all
my	PP$	my
desires.	NN	desires.
I	PP	I
have	VHP	have
nothing	RB	nothing
left	VVN	leave
for	IN	for
a	DT	a
son,	NP	son,
a	DT	a
daughter,	NP	daughter,
the	DT	the
only	JJ	only
one	CD	one
I	PP	I
wanted	VVD	want
to	TO	to
feel	VV	feel
sorry	JJ	sorry
for,	NNS	for,
a	DT	a
niece	NN	niece
of	IN	of
hers.	NN	hers.
I	PP	I
lost	VVD	lose
her	PP$	her
today.	NP	today.
All	NP	All
I	PP	I
have	VHP	have
left	VVN	leave
is	VBZ	be
the	DT	the
boy.	JJ	boy.
Oh	UH	oh
Lord,	NP	Lord,
I	PP	I
do	VVP	do
nâ€™t	RB	n't
know	VV	know
what	WP	what
to	TO	to
say.	NN	say.
There	EX	there
is	VBZ	be
no	DT	no
god	NN	god
but	CC	but
there	EX	there
is	VBZ	be
no	DT	no
god	NN	god
but	CC	but
praise.	NNS	praise.
[	SYM	[
Music]	JJ	Music]
</doc>	NN	</doc>
