<video_id>2pgFrmNgjUo</video_id>	JJ	<video_id>2pgFrmNgjUo</video_id>
<video_title>'A	NN	<video_title>'A
bird	NN	bird
in	IN	in
heaven':	JJ	heaven':
Grandfather	NN	grandfather
cradles	VVZ	cradle
7-year-old	JJ	7-year-old
granddaughter	NN	granddaughter
killed	VVN	kill
in	IN	in
southern	JJ	southern
Gaza</video_title>	NP	Gaza</video_title>
<thumbnail_path>data/en_CNN\'A	NN	<thumbnail_path>data/en_CNN\'A
bird	NN	bird
in	IN	in
heaven'	NP	heaven'
Grandfather	NN	grandfather
cradles	VVZ	cradle
7-year-old	JJ	7-year-old
granddaughter	NN	granddaughter
killed	VVN	kill
in	IN	in
southern	JJ	southern
Gaza.jpg</thumbnail_path>	NP	Gaza.jpg</thumbnail_path>
<publish_date>20240210</publish_date>	NN	<publish_date>20240210</publish_date>
<doc>	NN	<doc>
МИЛЛИОНЛА	NN	МИЛЛИОНЛА
ЕИҲАЗ	NN	ЕИҲАЗ
ИХЫЦХЫЗ	NN	ИХЫЦХЫЗ
ПАЛЕСТИНАА	NN	ПАЛЕСТИНАА
УАЗЫ	NN	УАЗЫ
ИАХЫРХЬЫРТӘУП,	NP	ИАХЫРХЬЫРТӘУП,
ЕИДЫРКЫЛОУ	NP	ЕИДЫРКЫЛОУ
АЖӘЛАР	NP	АЖӘЛАР
CNN	NP	CNN
НАДА	JJ	НАДА
БАШИР	NN	БАШИР
ГАЗА	NN	ГАЗА
Аҵыхәтәантәи	NN	Аҵыхәтәантәи
ашьакаҭәара	NN	ашьакаҭәара
иазкны	NN	иазкны
ажәабжь	NN	ажәабжь
ҟалҵоит.	JJ	ҟалҵоит.
ИАРБЖЬЫЗ	NN	ИАРБЖЬЫЗ
ҲАЗХЫРХЬЫРТ	NN	ҲАЗХЫРХЬЫРТ
АЗЫХЬЫСХЫЗ	NN	АЗЫХЬЫСХЫЗ
&gt;&gt;	NN	&gt;&gt;
ИАМАМ	NN	ИАМАМ
АЖӘАҚӘА	NN	АЖӘАҚӘА
АНГХ	NN	АНГХ
ИКЪЫРХЬЫЗ	NN	ИКЪЫРХЬЫЗ
АШЫҚӘСАЛА	NN	АШЫҚӘСАЛА
ИЛЫМХЫРТЫРТ	NN	ИЛЫМХЫРТЫРТ
BIE	NP	Bie
WN	NP	WN
T	NN	T
D	NP	D
R	NP	R
АНЫ	JJ	АНЫ
Уажәы	NN	Уажәы
А	NN	А
Б	NN	Б
ҲАЗЫМХЫРТЫЗ	NN	ҲАЗЫМХЫРТЫЗ
АБАЗЫЗ	NN	АБАЗЫЗ
Иара	JJ	Иара
Л'	NP	Л'
ИАНУНИС	NN	ИАНУНИС
АСААТҚӘА	NN	АСААТҚӘА
РЫЛА	NN	РЫЛА
АШКОЛА	NN	АШКОЛА
Аҿы	NN	Аҿы
ҲАНУНИС	NN	ҲАНУНИС
АСААТҚӘА	NN	АСААТҚӘА
РЫЛА	NN	РЫЛА
ИТӘЫРХЫРТ	NN	ИТӘЫРХЫРТ
.	SENT	.
ХЫС	JJ	ХЫС
ТО	JJ	ТО
РЕТ	NN	РЕТ
ТРЕАТ	NN	ТРЕАТ
ЛИТЛ	NN	ЛИТЛ
АТОЛЛ	NN	АТОЛЛ
Б	NN	Б
ИТ	NN	ИТ
ВАС	NN	ВАС
ТОО	NN	ТОО
ЛАТЕОСС	NN	ЛАТЕОСС
ГАЗА	NN	ГАЗА
10,0	CD	@card@
инареиҳаны	NN	инареиҳаны
АХӘЫҶҚӘА	NN	АХӘЫҶҚӘА
РЫХЬЫСЫРТ	NN	РЫХЬЫСЫРТ
АИБАШЬРА	NN	АИБАШЬРА
АЛАГЬЫЗ	NN	АЛАГЬЫЗ
Аҟынтәи.	JJ	Аҟынтәи.
АККОРДТОЕ	NN	АККОРДТОЕ
ХАМАС-РУН	NN	ХАМАС-РУН
ХЕТ	NN	ХЕТ
МИНИСТРОСТЬ	NN	МИНИСТРОСТЬ
МА	NN	МА
ЕИҲАНЫ	NN	ЕИҲАНЫ
ИЕИТМОУ	NN	ИЕИТМОУ
'ЛЛ	NN	'ЛЛ
ФАСИНФЕ	NN	ФАСИНФЕ
ИЗЫХЬЫРХЬЫЗ	NN	ИЗЫХЬЫРХЬЫЗ
АХӘРА	NN	АХӘРА
АЦЕНТРАЛЬНЫЙ	NN	АЦЕНТРАЛЬНЫЙ
СИДАНИЕЛЬ	NN	СИДАНИЕЛЬ
БЕЛЛА	NN	БЕЛЛА
АИТРИКН	NN	АИТРИКН
ЕДЛИ	NN	ЕДЛИ
ОСЕ	NN	ОСЕ
ИЗЫЛХЫЗ	NN	ИЗЫЛХЫЗ
ИАНЫЗХЫРХЬЫЗ	NN	ИАНЫЗХЫРХЬЫЗ
РЫЗХЫРХӘЫЛА	NN	РЫЗХЫРХӘЫЛА
АХЫРХӘЫЛАЗ	NN	АХЫРХӘЫЛАЗ
АШӘАРТӘЫРТӘ	JJ	АШӘАРТӘЫРТӘ
ЗОНА,	NP	ЗОНА,
ООН	NN	ООН
ИФОИТ	NN	ИФОИТ
УА	NN	УА
Е	NN	Е
Уажәы	NN	Уажәы
600,000	CD	@card@
инареиҳаны	NN	инареиҳаны
ахәыҷқәа	NN	ахәыҷқәа
рымоуп	NN	рымоуп
1	CD	@card@
МИЛЛИОН	NN	МИЛЛИОН
ИРЫЛХЫЗ	NN	ИРЫЛХЫЗ
АУАА	NN	АУАА
Аҭыԥан.	JJ	Аҭыԥан.
Аӡәырҩы	NN	Аӡәырҩы
ауаа	NN	ауаа
ИЗРАИЛИТӘИ	NN	ИЗРАИЛИТӘИ
МИРИ	NN	МИРИ
ҲАМАС	NN	ҲАМАС
ИХЫРХЬЫРТ	NN	ИХЫРХЬЫРТ
ИЗЫРХЫРХЬОИТ	NN	ИЗЫРХЫРХЬОИТ
АХА	NN	АХА
Уажәы	NN	Уажәы
ҲАМАС	NN	ҲАМАС
АОПЕРАЦИА	NN	АОПЕРАЦИА
АШӘАРА	NN	АШӘАРА
ИРЫЛХЫРТУЕИТ	NN	ИРЫЛХЫРТУЕИТ
ИВЕ	NN	ИВЕ
.	SENT	.
ЕСЛИ	JJ	ЕСЛИ
ИНВАЗИЯ	NN	ИНВАЗИЯ
ОФ	JJ	ОФ
РЕФЕРА,	NP	РЕФЕРА,
ДВА	NN	ДВА
ТРЕТИ	NN	ТРЕТИ
ПУЛАЦИИ	NN	ПУЛАЦИИ
БУДЕТ.	JJ	БУДЕТ.
ЏЬАВА	NN	ЏЬАВА
САИ'Ф	NN	САИ'Ф
&gt;&gt;	NN	&gt;&gt;
АВИД	NN	АВИД
ИСРЛ	NN	ИСРЛ
САТ	NN	САТ
Уажәы	JJ	Уажәы
ЛЛЛИНГ	NP	ЛЛЛИНГ
АЦИВИАНЦӘА	NN	АЦИВИАНЦӘА
РМАССА	NN	РМАССА
ЕВУАЦИАЗ	NN	ЕВУАЦИАЗ
АХЫ	NN	АХЫ
УТЕРН	NN	УТЕРН
АҚАЛАҚЬ	NN	АҚАЛАҚЬ
АПЛАНД	NN	АПЛАНД
ГР	NN	ГР
АПРЕДА	NN	АПРЕДА
ИТ	NN	ИТ
ИМПОЗИРОВАНИЕ	NN	ИМПОЗИРОВАНИЕ
ТО	NN	ТО
ФАТХОМ	NN	ФАТХОМ
ВРЕ	NN	ВРЕ
ЕС	NN	ЕС
КАН	NN	КАН
ТУРН	NN	ТУРН
ТО	NN	ТО
БОТ	NN	БОТ
ТОТ	NN	ТОТ
ПРОФЛОЖЕНИЕИС	NN	ПРОФЛОЖЕНИЕИС
НОТ	NN	НОТ
ОФЕЛЕКВЕТХЕСО	NN	ОФЕЛЕКВЕТХЕСО
КРУЦИАЛЬНЫЙ	NN	КРУЦИАЛЬНЫЙ
ГЕЙТВЕЙ	NN	ГЕЙТВЕЙ
R	NN	R
АГУМАНИТВ	NN	АГУМАНИТВ
МЫСРЫНТӘИ.	JJ	МЫСРЫНТӘИ.
И	NN	И
&gt;&gt;Y	NN	&gt;&gt;Y
ЖӘЛАРБЖӘЕИ	NN	ЖӘЛАРБЖӘЕИ
Ауаажәларраҿы	NN	Ауаажәларраҿы
Уажәы	NN	Уажәы
ибжьы	NN	ибжьы
рҳәоит	NN	рҳәоит
М	JJ	М
Агәҽанҵара,	NP	Агәҽанҵара,
ҷыдала	NN	ҷыдала
АРРАЛА	NN	АРРАЛА
РЫЗХЫРХӘЫРТЫРТ	NN	РЫЗХЫРХӘЫРТЫРТ
АШЬТЫЛА	NN	АШЬТЫЛА
Е	NN	Е
&gt;&gt;	NN	&gt;&gt;
ИРЫДЫРГЫЛОУП	NN	ИРЫДЫРГЫЛОУП
АШӘАРТӘЫРА	NN	АШӘАРТӘЫРА
АШТАТ	NN	АШТАТ
АШЬТАРА	NN	АШЬТАРА
М	NN	М
ЕЗИДЕНТ	NN	ЕЗИДЕНТ
ЏЬО	NN	ЏЬО
БИН	NN	БИН
АХАШЬША	NN	АХАШЬША
ИЗРАИЛЬТӘИ	NN	ИЗРАИЛЬТӘИ
А	NN	А
ҲАМАС	NN	ҲАМАС
Аҟынтәи	NN	Аҟынтәи
АПРОПОЗАЦИА	NN	АПРОПОЗАЦИА
ПРОЛД	JJ	ПРОЛД
АИАШЬАЗ,	NP	АИАШЬАЗ,
ГАЗАҟынтәи	NN	ГАЗАҟынтәи
ИСРАИ	NN	ИСРАИ
АИРЛАЦӘА	NN	АИРЛАЦӘА
ЕИҚӘЫРГЬЫЛА	NN	ЕИҚӘЫРГЬЫЛА
ИРЫЦХЫРТ.	NP	ИРЫЦХЫРТ.
НЕТАНИАХУ,	NP	НЕТАНИАХУ,
ПАЛЕСТИНАТӘИ	JJ	ПАЛЕСТИНАТӘИ
АБААНДАҚӘА	NN	АБААНДАҚӘА
РЫЦӘЫРГЬЫЛА	NN	РЫЦӘЫРГЬЫЛА
АБААНТҚӘА	NN	АБААНТҚӘА
РЫРХЫРХЬЫРА	NN	РЫРХЫРХЬЫРА
НЕТАНИАХУ,	NP	НЕТАНИАХУ,
W	NP	W
ҲАМАС	JJ	ҲАМАС
АЗЫ	NN	АЗЫ
АИАИРА	NN	АИАИРА
ҲАМАС	NN	ҲАМАС
АЗЫ	NN	АЗЫ
АИАИРА	NN	АИАИРА
ҲАЗХЫМХЫРТ.	NP	ҲАЗХЫМХЫРТ.
ЛЕИНГ	NP	ЛЕИНГ
ЛИ	NN	ЛИ
</doc>	NN	</doc>
