<video_id>JCAza8k6CyI</video_id>	NP	<video_id>JCAza8k6CyI</video_id>
<video_title>Blinken	NP	<video_title>Blinken
describes	VVZ	describe
how	WRB	how
the	DT	the
Israel-Hamas	JJ	Israel-Hamas
war	NN	war
affects	VVZ	affect
him	PP	him
personally</video_title>	NP	personally</video_title>
<thumbnail_path>data/en_CNN\Blinken	NP	<thumbnail_path>data/en_CNN\Blinken
describes	VVZ	describe
how	WRB	how
the	DT	the
Israel-Hamas	JJ	Israel-Hamas
war	NN	war
affects	VVZ	affect
him	PP	him
personally.jpg</thumbnail_path>	JJ	personally.jpg</thumbnail_path>
<publish_date>20231207</publish_date>	JJ	<publish_date>20231207</publish_date>
<doc>	NN	<doc>
BEAUTY	NN	beauty
I	PP	I
&gt;&gt;T	VVD	&gt;&gt;T
EVERYBODY	NN	everybody
TO	TO	to
SEEH.	NP	SEEH.
WE	PP	we
ALWE	NP	ALWE
APPRECIATE,E?	NP	APPRECIATE,E?
APPREEFFR	NP	APPREEFFR
BE	VB	be
PERSONALLY,	NP	PERSONALLY,
HAS.	NP	HAS.
HE	PP	he
TE	NN	te
ONGOG	NP	ONGOG
REE	NP	Ree
HOSTAGESTHEIFAMILIES.	NP	HOSTAGESTHEIFAMILIES.
'SBEGAN	NP	'SBEGAN
THERSATION.	NP	THERSATION.
&gt;&gt;	NN	&gt;&gt;
MISTER	NN	mister
SECRETARY,	NP	SECRETARY,
THANKOU	NP	THANKOU
UCH.	NP	UCH.
THT.	NP	THT.
KING	NN	king
FORWARD	RB	forward
THISEN'T	NP	THISEN'T
WE?	NP	WE?
&gt;&gt;SPECIAL.VERY	NP	&gt;&gt;SPECIAL.VERY
SCI	NP	SCI
THANKS	NNS	thanks
HAVING	VHG	have
T'S	NP	T'S
TA	NP	TA
ATAGEIF	NP	ATAGEIF
WE	PP	we
COULD.	NP	COULD.
BROKEN	VVN	break
DOWN,	NP	DOWN,
THE	NP	THE
WAODDWIDE	NP	WAODDWIDE
IT	PP	it
AE	NP	AE
HOSTAGES.	NP	HOSTAGES.
ON	NP	ON
DECK,	NP	DECK,
ALL	DT	all
COUNTRIES	NNS	country
WORKINTOS,	NP	WORKINTOS,
M	NP	M
HOME	NP	HOME
SAFELY,	NP	SAFELY,
BUT	CC	but
I'M	NP	I'M
WONDERING,	NP	WONDERING,
IS	VBZ	be
ANYTHING	NN	anything
OF	IN	of
TING	NN	ting
WE	PP	we
WANT	VVP	want
ALL	PDT	all
THE	DT	the
STAGES	NNS	stage
HOME?	NP	HOME?
&gt;&gt;	NP	&gt;&gt;
GAIL,	NP	GAIL,
WHEIS	NP	WHEIS
EVERYAY.	NP	EVERYAY.
ONESPONSIBILITY,	NP	ONESPONSIBILITY,
I	PP	I
KNISS	NP	Kniss
ER	UH	er
TO	TO	to
OK	JJ	OK
OUT	IN	out
AMERICAN	NP	AMERICAN
O	NP	O
IABESPECIALLY	NP	IABESPECIALLY
CAPTIVH	NP	CAPTIVH
THE	DT	the
FA	NN	fa
HEA	NP	HEA
THEM,	NP	THEM,
AND	CC	and
THAT'S	NP	THAT'S
THE	DT	the
THING	NN	thing
THAT	IN/that	that
ME	PP	me
M	NP	M
WILL	MD	will
IL	NP	Il
WGET	NP	WGET
EVERY	DT	every
SINGLE	JJ	single
OT'S	NN	OT'S
NOT	RB	not
ENOUGH.	NP	ENOUGH.
L	NP	L
THE	NP	THE
MR.	NP	Mr.
SECRETARIES,	NP	SECRETARIES,
ALL	RB	all
THESE	DT	these
NUMBE,,MT	NP	NUMBE,,MT
THEYY	NP	THEYY
MEMBERYTHING.	NP	MEMBERYTHING.
&gt;&gt;Y	NN	&gt;&gt;Y
WHAT	WP	what
YOU	PP	you
GUYS	VVZ	guy
ARG?	JJ	ARG?
YOU	PP	you
UNDERSTAND	VVP	understand
I	PP	I
CAN'T	JJ	CAN'T
BECAUSE	IN	because
THISGOG	NP	THISGOG
ON	NP	ON
ANTHAN	NP	ANTHAN
DAILY,	NP	DAILY,
SOMETIMES	RB	sometimes
EVEN	RB	even
H	NP	H
TD	NP	TD
AN	DT	an
ANGLE	NN	angle
TOT	NN	tot
TH	NN	th
RESTARTED.	NP	RESTARTED.
AND	CC	and
YOIT'S	NP	YOIT'S
NOT	RB	not
A	DT	a
QUEIO	NP	QUEIO
NUMBERS.	NP	NUMBERS.
THREVEL	NP	THREVEL
FAMILI,	NP	FAMILI,
N	NP	N
E	NP	E
DOWN.	NP	DOWN.
APF	NP	APF
EM.	NP	EM.
TH.SEA,	NP	TH.SEA,
E	NP	E
Y	NP	Y
HAMAS	NP	HAMAS
GETS	VVZ	get
THE	DT	the
VOTE.AND	NP	VOTE.AND
HAMAS	NP	HAMAS
PEAGES,	NP	PEAGES,
IT	PP	it
RMMIT.	NP	RMMIT.
THEY	PP	they
CHOSE	VVD	choose
TO	TO	to
AND	NP	AND
THIS	DT	this
PROCESS	NN	process
THTA	NP	THTA
HOSTAGES.	NP	HOSTAGES.
E	NP	E
FS	NNS	f
CIVILIANINAZT	NP	CIVILIANINAZT
ACTUHAI	NP	ACTUHAI
THINKO	NP	THINKO
E.	NP	E.
HAPPENED	VVD	happen
ON	RP	on
OCTSOMETHING	NP	OCTSOMETHING
I	NP	I
HAVF	NP	HAVF
S,	NP	S,
PARENTSTENT	NP	PARENTSTENT
OF	IN	of
THE	DT	the
CHILDRENIN	NP	CHILDRENIN
WHAT	WP	what
WASDELIBERATELY,	NP	WASDELIBERATELY,
Y,	NP	Y,
WITH	IN	with
THE	DT	the
THEN	JJ	then
U	NP	U
S	NP	S
TEOUP,	NP	TEOUP,
HAMAS	NP	HAMAS
TREATD	NP	TREATD
AI	VVZ	ai
TOD	NN	tod
INTE	NP	INTE
APARTMENT	NN	apartment
BUDIAN	NP	BUDIAN
AIL	VVP	ail
MOSQUNDEHOOLT'VECHALLENGING	NP	MOSQUNDEHOOLT'VECHALLENGING
ISRAEL	NP	Israel
TO	TO	to
DO	VV	do
WHAEE	NP	WHAEE
TO	TO	to
TRY	VV	try
TOSURT	NP	TOSURT
EVERAPNSND	NP	EVERAPNSND
T	NN	T
HAMAVING	NP	HAMAVING
SAID,	NP	SAID,
THAHAVEFR	NP	THAHAVEFR
N	NP	N
LI	NP	Li
DEVERYTHING	NP	DEVERYTHING
POSSIBLE	JJ	possible
TO	TO	to
PROTECVILIAN	NP	PROTECVILIAN
TO	TO	to
DISTINGUISH	VV	distinguish
BEISTS	NP	BEISTS
CHILDREN.OMEN,	NP	CHILDREN.OMEN,
AND	CC	and
&gt;&gt;	JJ	&gt;&gt;
THAT	IN/that	that
PART	NN	part
DOE	NNS	doe
SEEM	VVP	seem
TO	TO	to
BE	VB	be
SO	RB	so
WELL,SE	JJ	WELL,SE
ABLIANS	NP	ABLIANS
E	NP	E
CIVILIS	NP	CIVILIS
OF	IN	of
CHILDREN.	NP	CHILDREN.
EVERYBOD	NP	EVERYBOD
EN	IN	en
GUT-WRENCHIUS.	NP	GUT-WRENCHIUS.
SOME	DT	some
IMPTATABEG	NN	IMPTATABEG
TO	TO	to
THE	DT	the
SOUTH	NN	south
HE	PP	he
A	DT	a
REPEAT	NN	repeat
OFENT	NP	OFENT
ACLRL	NP	ACLRL
I	PP	I
WAS	VBD	be
AT	IN	at
HAPPENED	VVN	happen
IN	IN	in
THE	DT	the
N	NP	N
TERMS	NNS	term
OF	IN	of
HM	UH	hm
WHO	WP	who
NEEDEDIS	NP	NEEDEDIS
MAK	NP	Mak
,	,	,
WAR,	NP	WAR,
SHELT.	NP	SHELT.
ARE	VBP	be
SEEING	VVG	see
IS	VBZ	be
CLEARLY	RB	clearly
DEGNATED	JJ	DEGNATED
BTH	NP	BTH
AS	NP	AS
WHERE	WRB	where
EFE	NP	EFE
SUREPLE	NP	SUREPLE
ME	FW	me
CITTHAT'S	NP	CITTHAT'S
POSITIVE.	NP	POSITIVE.
THAT	IN/that	that
HASO	NP	HASO
EEO	NP	EEO
DONE.	NP	DONE.
OPLE	NP	Ople
HAVE	VHP	have
EAS	NP	EAS
MASE	NP	Mase
AREASE	NP	AREASE
SAFE,	NP	SAFE,
VE	NP	VE
THE	NP	THE
PROPER,	NP	PROPER,
HAVED,	NP	HAVED,
WATER,	NP	WATER,
HAVE	VHP	have
TOR	NN	tor
.	SENT	.
SO	RB	so
THERE	RB	there
ARER	NN	ARER
OF	IN	of
THINGS	NNS	thing
H	NP	H
NGAW	NP	NGAW
IS	VBZ	be
MAANO	NP	MAANO
PERSONAY,	NP	PERSONAY,
AND	CC	and
HOWECT	NP	HOWECT
YOU?	NP	YOU?
UGGLING.	NP	UGGLING.
I'VEKETHAT	NP	I'VEKETHAT
A	DT	a
LITTLE	JJ	little
ASEL	NP	Asel
DIED	VVD	die
IAUSCHWITZ,	NP	IAUSCHWITZ,
IN	IN	in
TH	NN	th
IN	IN	in
GENERATION	NN	generation
INTERNALIZEGOHAT	NN	INTERNALIZEGOHAT
IS	VBZ	be
NOW	RB	now
UKRAINE	NP	Ukraine
BT	NP	BT
SONEF	NP	SONEF
COURSE,	NP	COURSE,
IT	PP	it
ESIDENCE.	NP	ESIDENCE.
AND	CC	and
A	DT	a
RESIDENTS	NNS	resident
THATOES	NP	THATOES
TO	TO	to
OPTHE	NP	OPTHE
TED.	NP	TED.
AMANPLWO	NP	AMANPLWO
STATEREPRESENTING	NP	STATEREPRESENTING
ALLTH	NP	ALLTH
PRESIDENT.	NP	PRESIDENT.
TO	TO	to
MSU	NP	MSU
AMERICAAMERICAS	NP	AMERICAAMERICAS
VALUE	NN	value
AH.	NP	AH.
SAFE	NN	safe
ARE	VBP	be
JISENTS	NP	JISENTS
W	NP	W
IS	VBZ	be
THE	DT	the
LINE	NN	line
BETWEEN	IN	between
HATEFREEDO	NP	HATEFREEDO
SPEEC	NP	SPEEC
I	NP	I
FOCE	NP	FOCE
WORLDYOND	NP	WORLDYOND
OUROR,	NP	OUROR,
LIKE	IN	like
AE	NP	AE
ADG	NP	ADG
HEARIN,	NP	HEARIN,
TALKIN	NP	TALKIN
MOWN	VVN	mow
.	SENT	.
SRELY	NP	SRELY
NEWITDENTSE	NP	NEWITDENTSE
OF	IN	of
THEE	PP	thee
THAC	NP	Thac
ROCK	NN	rock
SINCE	IN	since
OCTOBER	NP	October
7TH.	NP	7TH.
Y	NP	Y
DISTURD	NP	DISTURD
OF	IN	of
HATREG	NP	HATREG
LIM	NP	Lim
AMERICANB	NP	AMERICANB
AMAN	NP	Aman
SEE	VVP	see
THIS	DT	this
IN	IN	in
A	DT	a
DIL	NP	DIL
D	NP	D
SATHEYBEE.	NP	SATHEYBEE.
RAISE	VV	raise
A	DT	a
REA	NP	REA
EELING	NP	EELING
SD	NP	SD
E	NP	E
I	PP	I
KNOW	VVP	know
SO	IN	so
MANYE	NP	MANYE
HEIT	NP	Heit
SGUGGLING	NP	SGUGGLING
WITH	IN	with
EVENVEETARYO	NP	EVENVEETARYO
D	NP	D
E	NP	E
STOP	VV	stop
IWE	NP	IWE
HAVE	VH	have
TO	TO	to
RTYN	NP	RTYN
.TO	NP	.TO
TE	NN	te
AV	NP	AV
OPENNESS	NN	openness
WHEN	WRB	when
YOU	PP	you
HAVE	VH	have
THATLK	NP	THATLK
ABOUT	IN	about
ANYT.	NP	ANYT.
BUT	CC	but
ONCEOUON	NP	ONCEOUON
SEEING	VVG	see
SOME	DT	some
ANOTHET	NP	ANOTHET
HUMAN,	NP	HUMAN,
THAT	WDT	that
TAKES	VVZ	take
EVERY	DT	every
CHECK	NN	check
AWAY.	NP	AWAY.
I	NP	I
AT	IN	at
EXACTLY.	NP	EXACTLY.
&gt;&gt;	NN	&gt;&gt;
WHAT	WP	what
PART	NN	part
DO	VVP	do
OUR	PP$	our
POTI	NP	POTI
AYEDE	NP	AYEDE
EVERY	DT	every
DAY,	NP	DAY,
THE	DT	the
DEMOCRATS	NNS	democrat
AND	CC	and
REL	NP	REL
WHAT	WDT	what
PART	NN	part
N	NP	N
USRELNETHINGS	NP	USRELNETHINGS
ABOUTG	NP	ABOUTG
SECRETARY	NN	secretary
OF	IN	of
STATE'S,	NP	STATE'S,
I	NP	I
DON'T	NP	DON'T
DO	VVP	do
POLITICS.	NP	POLITICS.
AND	CC	and
I	NP	I
DON'T	NP	DON'T
WANT	VVP	want
TSTART	NP	TSTART
[LAUTER].	NP	[LAUTER].
WAIT	VV	wait
A	DT	a
SECOND,	NP	SECOND,
MISTER	NN	mister
ETARY.	NP	ETARY.
HERE'S	NP	HERE'S
T	NN	T
THING.IS	NP	THING.IS
TIWHAT	NP	TIWHAT
DO	VV	do
YOUI	NP	YOUI
I	PP	I
HAVE	VHP	have
HEARD	VVN	hear
PRESIDENT	NN	president
S	NN	S
I	PP	I
HAVE	VHP	have
E	NN	E
E	NN	E
OF	IN	of
WORKING	VVG	work
WITH	IN	with
H	NN	H
FOR	IN	for
MORE	JJR	more
TH	NN	th
20	CD	@card@
YEA	NN	yea
AND	CC	and
T	NN	T
HAS	VHZ	have
CONSTANTLYVET'TOTALLYS	NP	CONSTANTLYVET'TOTALLYS
BUSTOP	NP	BUSTOP
QH	NP	QH
OTHER'S	NP	OTHER'S
MOTIVES.	NP	MOTIVES.
LES	FW	les
ASSUME	VVP	assume
ARE	VBP	be
GOOTIODNTENTIONSO	NP	GOOTIODNTENTIONSO
K	NP	K
THAT'S	NP	THAT'S
WHAWE	NP	WHAWE
L.	NP	L.
&gt;&gt;	NN	&gt;&gt;
UNLIKE	IN	unlike
WHAT	WP	what
YOU	PP	you
SAID	VVD	say
ABOUT	RB	about
HAVE	VH	have
C	NP	C
ABO	NP	ABO
WHAT	WP	what
IS	VBZ	be
URTHAT	NP	URTHAT
GETS	VVZ	get
YOU	PP	you
THROUGH?	NP	THROUGH?
TH	NN	th
WYO	NP	Wyo
TO	TO	to
MEERO,	NP	MEERO,
THE	NP	THE
GREATSI	NP	GREATSI
HAD	VHD	have
A	DT	a
CHAT	NN	chat
DIRECTOR	NN	director
AND	CC	and
ACTOR,	NP	ACTOR,
AND	NP	AND
HE	PP	he
MADE.	NP	MADE.
ONE	CD	one
OF	IN	of
THE	DT	the
CHARACTERS	NNS	character
YSTONE	NP	YSTONE
POE	NP	Poe
LINE	NN	line
BETWEENVED	NP	BETWEENVED
STUPID.	NP	STUPID.
OF	IN	of
THAT	DT	that
LINERY	NP	LINERY
OKAY.	NP	OKAY.
</doc>	NN	</doc>
