<video_id>RSh5z9IhleI</video_id>	NP	<video_id>RSh5z9IhleI</video_id>
<video_title>CNN	NP	<video_title>CNN
anchor	NN	anchor
breaks	VVZ	break
down	RP	down
questions	NNS	question
surrounding	VVG	surround
'tragic	JJ	'tragic
errors'	NNS	errors'
in	IN	in
Israel's	NP	Israel's
war	NN	war
against	IN	against
Hamas</video_title>	NP	Hamas</video_title>
<thumbnail_path>data/en_CNN\CNN	NP	<thumbnail_path>data/en_CNN\CNN
anchor	NN	anchor
breaks	VVZ	break
down	RP	down
questions	NNS	question
surrounding	VVG	surround
'tragic	JJ	'tragic
errors'	NNS	errors'
in	IN	in
Israel's	NP	Israel's
war	NN	war
against	IN	against
Hamas.jpg</thumbnail_path>	NP	Hamas.jpg</thumbnail_path>
<publish_date>20240529</publish_date>	JJ	<publish_date>20240529</publish_date>
<doc>	NN	<doc>
ҲАМАС	NN	ҲАМАС
АТЕРРОРИСТЦӘА	NN	АТЕРРОРИСТЦӘА
М	NN	М
ЕА	NN	ЕА
ЦФ	NN	ЦФ
РАК	NN	РАК
НЕ	NN	НЕ
ИЗЫЛХЫРТЫЗ	NN	ИЗЫЛХЫРТЫЗ
АИБАШЬРА	NN	АИБАШЬРА
ИАЛХЫРТУЕИТ.	NP	ИАЛХЫРТУЕИТ.
Салам	NP	Салам
АСАХӘТ.	NP	АСАХӘТ.
IT'S	NP	IT'S
RM	NP	Rm
МЕЕТИНГ	NP	МЕЕТИНГ
ТС	JJ	ТС
ТА	NN	ТА
ЛЕВС	NN	ЛЕВС
ИЗРАИЛЬ	NN	ИЗРАИЛЬ
ОНУРФАЦЕ	NN	ОНУРФАЦЕ
ОФ	NN	ОФ
НД	NN	НД
М	NN	М
АН	NN	АН
ИЗРАИЛЬ	NN	ИЗРАИЛЬ
БОМБА.	JJ	БОМБА.
Уажәы	NN	Уажәы
ари	NN	ари
ақәра	JJ	ақәра
C	NP	C
А	NN	А
ТЕНМФЕ	NN	ТЕНМФЕ
ПРАЙМ	NN	ПРАЙМ
МИНИС	NN	МИНИС
МАМЗАР	NN	МАМЗАР
АРАКЕТАҚӘА	NN	АРАКЕТАҚӘА
РКАЖАҚӘА	NN	РКАЖАҚӘА
АБАРА	NN	АБАРА
АПА	NN	АПА
АБОМБАҚӘА	NN	АБОМБАҚӘА
РЫЗКЫЗ	NN	РЫЗКЫЗ
АФЕВЕРТ	NN	АФЕВЕРТ
,	,	,
Y	NP	Y
ТРАГИКА	JJ	ТРАГИКА
Ҵыхәаԥҵәарада	NN	Ҵыхәаԥҵәарада
иҟалар	NN	иҟалар
алшома?	NN	алшома?
ХАНДР	NN	ХАНДР
ЕАТ	JJ	ЕАТ
ДИФРСТ,	NP	ДИФРСТ,
АРЕА	NN	АРЕА
АР	NN	АР
РАФАХ	NN	РАФАХ
ДЕСПЕРАЦИА	NN	ДЕСПЕРАЦИА
ИС	NN	ИС
ХИД	NN	ХИД
АНД	NN	АНД
УОТЕР	NN	УОТЕР
АРЕ	NN	АРЕ
СК	NN	СК
АБАРА'W	NN	АБАРА'W
ИТАКЕШИФТ	NN	ИТАКЕШИФТ
ШЕИАМОНД	NN	ШЕИАМОНД
ДАСКРИБЕС	NN	ДАСКРИБЕС
ФЛЕМС	NN	ФЛЕМС
СКРЕА	JJ	СКРЕА
ЦЕР,	NP	ЦЕР,
ИМОУ	NN	ИМОУ
БОДИЕАРНЫЕ	NN	БОДИЕАРНЫЕ
ТИМБИНГСРОМ	NN	ТИМБИНГСРОМ
БЛЕЗЕ	NN	БЛЕЗЕ
СЛЕЕП.	JJ	СЛЕЕП.
ЕГЬЫРТ	NN	ЕГЬЫРТ
АШЬА	NN	АШЬА
БЗЫ	JJ	БЗЫ
АКУРЛИНГ	NP	АКУРЛИНГ
СКРЕМЛЛОФ	NN	СКРЕМЛЛОФ
УНО	NN	УНО
ЕИҲА	NN	ЕИҲА
УОС	NN	УОС
&gt;&gt;	NN	&gt;&gt;
АХА	NN	АХА
ИТЫЗ	NN	ИТЫЗ
МАЦАРА	NN	МАЦАРА
ИНФЕРНО	NN	ИНФЕРНО
АР	NN	АР
ИЛЫРГЫЛОУП	JJ	ИЛЫРГЫЛОУП
РИБЛПАИ	NN	РИБЛПАИ
SE	FW	se
WHO	WP	who
NE	RB	ne
THRECHERMECYFAMILES	NP	THRECHERMECYFAMILES
ГА	NN	ГА
АБРИ	NN	АБРИ
МАХОСЕ	NN	МАХОСЕ
БРО	NN	БРО
ИАҲӘОИТ	NN	ИАҲӘОИТ
СТРАЙК	NN	СТРАЙК
С	NN	С
И	NN	И
ВОН.	JJ	ВОН.
Иара	NN	Иара
Иҳәоит	NN	Иҳәоит
АЗАКЫЗ	NN	АЗАКЫЗ
АНШАТ	NN	АНШАТ
АУАА	NN	АУАА
РЕПОРИА	NN	РЕПОРИА
СТ	NN	СТ
ОЕР	NN	ОЕР
ТХВАРИ	NN	ТХВАРИ
ДЕПЕ	NN	ДЕПЕ
С	NN	С
АЗЫРХЬЫЗ	NN	АЗЫРХЬЫЗ
ИБАЗ	NN	ИБАЗ
ИМА	NN	ИМА
ИШЬЫЗ	NN	ИШЬЫЗ
АЗААБАДА	NN	АЗААБАДА
Б	NN	Б
ААТ	NN	ААТ
АХӘЫ	NN	АХӘЫ
ШЬАКЬЫЗ	NN	ШЬАКЬЫЗ
АЗЫХЫРХЬЫРТ	NN	АЗЫХЫРХЬЫРТ
АЗЫХЫРХЬЫЗ	NN	АЗЫХЫРХЬЫЗ
АХЫСХЫРТ	NN	АХЫСХЫРТ
ИЫМХЫРТ	NN	ИЫМХЫРТ
ФЕ	JJ	ФЕ
ИТ'ТИНГ	NP	ИТ'ТИНГ
ТО	NN	ТО
Е	NN	Е
ФАР	NN	ФАР
ТОО	NN	ТОО
АОПЕРАЦИАҚӘА.	JJ	АОПЕРАЦИАҚӘА.
T	NN	T
OF	IN	of
COMBAT	NN	combat
&gt;&gt;	JJ	&gt;&gt;
WWI	NP	WWI
С	NN	С
НАШИМ	NN	НАШИМ
ИЗРАИЛЬСКИМ	NN	ИЗРАИЛЬСКИМ
ПАРТНАНДИ	NN	ПАРТНАНДИ
ТАЙ	NN	ТАЙ
МЕРЫ	NN	МЕРЫ
ТО	NN	ТО
ОТ	NN	ОТ
ВЕРЕЕТ	NN	ВЕРЕЕТ
И	NN	И
АН	NN	АН
АНГАЖИРОВАТЬ	NN	АНГАЖИРОВАТЬ
С	NN	С
НАШИМИ	NN	НАШИМИ
ИСРАНЕНИМ	NN	ИСРАНЕНИМ
А	NN	А
ЗАХРА.	JJ	ЗАХРА.
&gt;&gt;	NN	&gt;&gt;
Аӡәгьы	NN	Аӡәгьы
иҭахӡам	NN	иҭахӡам
хара	NN	хара
змам	NN	змам
ацивилцәа	NN	ацивилцәа
рышьра	NN	рышьра
ИИС	NN	ИИС
АКОНФЛИКТ,	NP	АКОНФЛИКТ,
WHETHEINIAN	NP	WHETHEINIAN
ORAELI.	NP	ORAELI.
Е	JJ	Е
Л	NN	Л
ПАЛЕСТИНА	NN	ПАЛЕСТИНА
ҲАРА	NN	ҲАРА
О	NN	О
КОТ	NN	КОТ
РА	NN	РА
НЕ	NN	НЕ
ВИОЛАТЕТЕ	NN	ВИОЛАТЕТЕ
РЕД	NN	РЕД
ЛИНИЯ	NN	ЛИНИЯ
ПРИЗОН	NN	ПРИЗОН
Т	NN	Т
С	NN	С
ИШЬТЫЗ,	NP	ИШЬТЫЗ,
WDONT	NP	WDONT
СЕЕ	JJ	СЕЕ
МАЖОР	NN	МАЖОР
ГР	NN	ГР
ХЕНАТ	NN	ХЕНАТ
ЭТИС	NN	ЭТИС
&gt;&gt;	NN	&gt;&gt;
МЕ	NN	МЕ
О	NN	О
АС	NN	АС
УС	NN	УС
БОДОНТ	NN	БОДОНТ
ХЕРЕДЕХЕТЕР	NN	ХЕРЕДЕХЕТЕР
ТА	NN	ТА
HE	PP	he
HE	PP	he
THE	DT	the
S?	NP	S?
ПОП	NN	ПОП
Аԥсахра	NN	Аԥсахра
ҲАЗХЫРХЬОУА?	NN	ҲАЗХЫРХЬОУА?
ҲАРА	NN	ҲАРА
АЗЫРГЬЫЛА	NN	АЗЫРГЬЫЛА
ҲАЗХЫРГЫЛОМ.	JJ	ҲАЗХЫРГЫЛОМ.
ОЦЕНТ	NN	ОЦЕНТ
ИЛ	NN	ИЛ
АЦИВИЛЬНЫЕ	NN	АЦИВИЛЬНЫЕ
КАЗУАЛТИЕСС.	NP	КАЗУАЛТИЕСС.
ИАРБЖЬЫЗ	NP	ИАРБЖЬЫЗ
АКЫМ,	NP	АКЫМ,
ҲАРА	JJ	ҲАРА
ИЗЫЗХЫРХЫЗ	NN	ИЗЫЗХЫРХЫЗ
ҲИСРЛИ	NN	ҲИСРЛИ
КОУНТЕТСИНКЛУДИРОВАНИЕ	JJ	КОУНТЕТСИНКЛУДИРОВАНИЕ
ЕД,	NP	ЕД,
ВИКЕНД	NN	ВИКЕНД
УП	NN	УП
С	NN	С
ЛЕММА	NN	ЛЕММА
ЕЛ	NN	ЕЛ
СЕЛЬФ	NN	СЕЛЬФ
В	NN	В
ЭТИ	NN	ЭТИ
УНСТА	NN	УНСТА
КОТЕТЕД	NN	КОТЕТЕД
КОТЕТЕ	NN	КОТЕТЕ
ИТЕТИ	NN	ИТЕТИ
ИЗРАИЛЬ	NN	ИЗРАИЛЬ
О	NN	О
РАФА	NN	РАФА
ЕР	NN	ЕР
ТЕЕР	NN	ТЕЕР
ИЗРАИЛЬНЫЕ	NN	ИЗРАИЛЬНЫЕ
НЕРС	NN	НЕРС
Р	NN	Р
ЛЕАНД	NN	ЛЕАНД
Ҳәарада	NN	Ҳәарада
ОМ	NN	ОМ
МОНЕ.	JJ	МОНЕ.
Т	NN	Т
НОТА	NN	НОТА
ОВИС	NN	ОВИС
УБРИ	NN	УБРИ
АХӘЫМЧАГЬ,	NP	АХӘЫМЧАГЬ,
48	CD	@card@
СААТ	NN	СААТ
АПАСТИ	NN	АПАСТИ
ИЗРАИЛИЦӘА	NN	ИЗРАИЛИЦӘА
ИРЫМХЫРТ	NN	ИРЫМХЫРТ
29ПЛЕ	JJ	29ПЛЕ
ИТВТТ	NN	ИТВТТ
ЛАМЕ	NN	ЛАМЕ
АБРЫ	NN	АБРЫ
ҾЫЦ	NN	ҾЫЦ
СТС	NN	СТС
АШЬРА	JJ	АШЬРА
ИСР'	NP	ИСР'
СЕЛЬФИНВЕСТИРОВАНИЕ	NN	СЕЛЬФИНВЕСТИРОВАНИЕ
С	NN	С
Ф	NN	Ф
ЛСО	NN	ЛСО
КИНОУ	NN	КИНОУ
АНОС	NN	АНОС
НДРЕД	NN	НДРЕД
ИТЕВАРИНЕВ	NN	ИТЕВАРИНЕВ
РАФА	NN	РАФА
ДЫЛАГЫЛОИТ,	NP	ДЫЛАГЫЛОИТ,
ЗЫЛХЫРТЫЗ	NP	ЗЫЛХЫРТЫЗ
ИРАФАХ	NP	ИРАФАХ
А,	NP	А,
РАФАХ	JJ	РАФАХ
ҲАМАС	NN	ҲАМАС
Б	NN	Б
Д	NN	Д
&gt;&gt;	JJ	&gt;&gt;
ААИ,	NP	ААИ,
ҲАРА	NN	ҲАРА
ГАЗА	NN	ГАЗА
АНДХЕАЛ	JJ	АНДХЕАЛ
Б''	NP	Б''
СУРВИВЕЛИ	NN	СУРВИВЕЛИ
ИФУТУРИ	NN	ИФУТУРИ
РЫЗКЫНТӘЫЗ	NN	РЫЗКЫНТӘЫЗ
АКЫЛАМА	NN	АКЫЛАМА
ҲАМОУП.	JJ	ҲАМОУП.
С	NN	С
АБХИ.	JJ	АБХИ.
ҲАМАС	NN	ҲАМАС
ПРОПАЛ	NN	ПРОПАЛ
ИЦЫСТОРПЕДО	NN	ИЦЫСТОРПЕДО
Т	NN	Т
Д	NN	Д
ППЕН.	JJ	ППЕН.
ҲАРА	NN	ҲАРА
ҲАИАХӘЫРТ	NN	ҲАИАХӘЫРТ
УСРЕ	NN	УСРЕ
ҲАИАЦӘАЦӘА	JJ	ҲАИАЦӘАЦӘА
Аҿы,	NP	Аҿы,
ҲАЗХЫРГЫЛОЗ	NN	ҲАЗХЫРГЫЛОЗ
ТАТ	NN	ТАТ
АЛИОНСР	NN	АЛИОНСР
ҲАЗХЫРГЬЫРТ	NN	ҲАЗХЫРГЬЫРТ
ҳәа	NN	ҳәа
ҲАЗЫМХЫРТ	NN	ҲАЗЫМХЫРТ
,	,	,
А	JJ	А
ада	NN	ада
,	,	,
STTHCI	NP	STTHCI
TACEMENT	NP	TACEMENT
IS	VBZ	be
RHEPEOPLE	NP	RHEPEOPLE
MOVCEO	NP	MOVCEO
NEED	VVP	need
MONEY.	NP	MONEY.
&gt;&gt;	NP	&gt;&gt;
ҲАРА'	NP	ҲАРА'
LT	NP	Lt
S	NP	S
ҲАРА	JJ	ҲАРА
ҲЫРКЫЛОУП	NN	ҲЫРКЫЛОУП
МОВ	NN	МОВ
НОРТ	NN	НОРТ
ҲАРА	NN	ҲАРА
ИНТЕНСИВНО	NN	ИНТЕНСИВНО
АБИСМАЛ	NN	АБИСМАЛ
НДИТИЕ	NN	НДИТИЕ
ХЕСПЛАЦЕМЕНТ	NN	ХЕСПЛАЦЕМЕНТ
БЕ	NN	БЕ
И	NN	И
ТОНИ	NN	ТОНИ
ФОРВАР	NN	ФОРВАР
МАС	NN	МАС
УИЛЛИСОЛАТ	NN	УИЛЛИСОЛАТ
ОБЪЕКТИВПАГУ	NN	ОБЪЕКТИВПАГУ
ИЗРАИЛЬ''ФЕРОРИСТЫ	NN	ИЗРАИЛЬ''ФЕРОРИСТЫ
НДИТЕИХЕВРЕ	NN	НДИТЕИХЕВРЕ
'	POS	'
ЕРИКАН	JJ	ЕРИКАН
СУППО	JJ	СУППО
УРТ	NN	УРТ
агхақәа	NN	агхақәа
рыла	NN	рыла
Аҵыхәтәантәи	NN	Аҵыхәтәантәи
А	NN	А
ОН	NN	ОН
П	JJ	П
БИДЕН,	NP	БИДЕН,
ЗЫМАЗЫРТЫЗ	NN	ЗЫМАЗЫРТЫЗ
ЕСЦИ	NN	ЕСЦИ
</doc>	NN	</doc>
