<video_id>V5AxIqP6OJM</video_id>	NN	<video_id>V5AxIqP6OJM</video_id>
<video_title>Explosions	NNS	<video_title>Explosions
go	VVP	go
off	RP	off
during	IN	during
interview	NN	interview
with	IN	with
American	JJ	American
doctor	NN	doctor
trapped	VVN	trap
in	IN	in
Gaza</video_title>	NP	Gaza</video_title>
<thumbnail_path>data/en_CNN\Explosions	NNS	<thumbnail_path>data/en_CNN\Explosions
go	VVP	go
off	RP	off
during	IN	during
interview	NN	interview
with	IN	with
American	JJ	American
doctor	NN	doctor
trapped	VVN	trap
in	IN	in
Gaza.jpg</thumbnail_path>	NP	Gaza.jpg</thumbnail_path>
<publish_date>20231010</publish_date>	JJ	<publish_date>20231010</publish_date>
<doc>	NN	<doc>
T	NN	T
NOW.	NP	NOW.
NEW	NP	NEW
STA	NP	STA
HAPP	NP	Happ
IC	NP	IC
QUESTION,	NP	QUESTION,
IS	VBZ	be
PRIS	NP	Pris
THEM,OUND	NP	THEM,OUND
IIOIM	NP	IIOIM
NETANYAHU	NP	NETANYAHU
LIKETH	NP	LIKETH
FOR	IN	for
ANOTHER	DT	another
COMPLETE	JJ	complete
SIEGE	NN	siege
OF	IN	of
GAZA	NP	Gaza
ANDNG	NP	ANDNG
THF	NP	THF
THE	NP	THE
E.WI	NP	E.WI
S2	NP	S2
PEOPLE	NNS	people
CROWDED	VVD	crowd
TOGETHER	RB	together
OA	NP	OA
140-SQ-M	NP	140-SQ-M
HTS	NP	HTS
AS	NP	AS
ON	NP	ON
EARTH?N	NP	EARTH?N
WEDEMAN	NP	WEDEMAN
IS	VBZ	be
IN	IN	in
JERO	NP	JERO
US.	NP	US.
I	NP	I
YF	NP	YF
TIME	NN	time
REPORTING	NN	reporting
FROM	IN	from
GAZA.	NP	GAZA.
YOU	PP	you
KNOW	VVP	know
HOW	WRB	how
DIFFICULTT	NP	DIFFICULTT
TERRAIN	NN	terrain
IS	VBZ	be
OVE	NP	Ove
US,URAT	NP	US,URAT
TOA	NP	TOA
WARFARE,	NP	WARFARE,
ANDNNELS	NP	ANDNNELS
AS	NP	AS
WELL	RB	well
TT	NP	TT
CORAWHAT	NP	CORAWHAT
COULD	MD	could
THE	DT	the
IDF	NP	IDF
FORCES	NNS	force
BE	VB	be
FACING	VVG	face
THERE?	NP	THERE?
S	NP	S
GOING	VVG	go
TO	TO	to
BE	VB	be
,	,	,
WOLF.	NP	WOLF.
TION	NN	tion
IS	VBZ	be
THAT	IN/that	that
THEY	PP	they
ARE	VBP	be
GOING	VVG	go
TO	TO	to
GOO	NN	goo
GA	NP	Ga
INHAAVEN'T	NP	INHAAVEN'T
S	NP	S
THE	NP	THE
PAST.	NP	PAST.
WAIN	NN	wain
2009	CD	@card@
WHEN	WRB	when
THE	DT	the
ISRAISINCUTHEY	NP	ISRAISINCUTHEY
BASICALLY	RB	basically
THE	DT	the
ST	NP	St
HE	PP	he
T	NN	T
AF	JJ	AF
'RE	NN	'RE
GOING	VVG	go
TO	TO	to
GO	VV	go
IN	IN	in
AND	NP	AND
TO,	NP	TO,
FOR	IN	for
INSTANCE	NN	instance
PT	NP	PT
ITHMAS	NP	ITHMAS
IS	VBZ	be
KEEPINGHE	NP	KEEPINGHE
AREAS	NNS	area
THAT	WDT	that
ARE	VBP	be
HEAVILY,	NP	HEAVILY,
FOR	IN	for
INSTANCE,	NP	INSTANCE,
LIKE	IN	like
REFUGAM,	NP	REFUGAM,
PULATED	NP	PULATED
OF	IN	of
RE	IN	re
THAT	DT	that
REFUGEE	NN	refugee
CAMP	NN	camp
IS	VBZ	be
COMPOSEOFRY	NP	COMPOSEOFRY
NARROW.	NP	NARROW.
SO	IN	so
IT'S	NP	IT'S
GOING	VVG	go
IN.	NP	IN.
AND,URSE,	NP	AND,URSE,
IT	PP	it
ISO	NP	ISO
FULT	NP	FULT
IT	PP	it
IS	VBZ	be
INEM	NP	INEM
SOHI	NP	SOHI
A	NP	A
VAZA.	NP	VAZA.
EROLENT	NP	EROLENT
OPERATION.	NP	OPERATION.
AND,	NP	AND,
OF	IN	of
COURSE,	NP	COURSE,
S,E	NP	S,E
EN	IN	en
THIS	DT	this
OPE	JJ	ope
ATN	NP	ATN
SATURDAY	NP	Saturday
WAVERY	NP	WAVERY
WELL	RB	well
EDTHEY	NP	EDTHEY
CLEARLYTUDIEI	NP	CLEARLYTUDIEI
OF	IN	of
THE	DT	the
OTH	NN	Oth
VAE,IVES	NP	VAE,IVES
W	NP	W
ONE	CD	one
AND	CC	and
THEIR	PP$	their
ASSUMPTIONS	NNS	assumption
PROBABLYY	NP	PROBABLYY
I	NP	I
COUNTERATTACK,	NP	COUNTERATTACK,
THE	DT	the
ISRAELI	JJ	Israeli
INVASION	NN	invasion
INSIDE	IN	inside
OFSEPAB	NP	OFSEPAB
ASG	NP	ASG
OF	IN	of
HAMAS.HEE	NP	HAMAS.HEE
ISRAELIS	NPS	Israelis
ANG	NP	Ang
T	NN	T
PES	NN	pes
THIFFICULT	NP	THIFFICULT
GROUNDPEHAVE	NP	GROUNDPEHAVE
DONE	VVN	do
CEIR	NP	CEIR
LE	DT	le
T	NN	T
I	PP	I
ED	VVN	edited
FROM	IN	from
GA	NP	Ga
SAYING.	NP	SAYING.
EVERYTHING	NN	everything
YOU'RE	NP	YOU'RE
FROW.	NP	FROW.
BARBAR	NP	Barbar
TNK	NP	TNK
N,N	NP	N,N
AMERIC	NP	AMERIC
PEDIATRICIANHOINGAZA	NP	PEDIATRICIANHOINGAZA
RIGHT	JJ	right
NTHEL	NP	NTHEL
ATREAT	NN	ATREAT
CHIN	NN	chin
WHEN	WRB	when
ON	NP	ON
ISRAEL.	NP	ISRAEL.
DR.	NP	Dr.
ZIN,	NP	ZIN,
THAOUJOINING	NP	THAOUJOINING
US	NP	US
AION	NP	Aion
IN	IN	in
USSCE	NP	USSCE
HEARING	NN	hearing
THES	NNS	THES
WALKING	VVG	walk
BEACH.ENED	NP	BEACH.ENED
TO	TO	to
B	NP	B
E	NP	E
PALESTINIAN	NP	Palestinian
CHILDREN'S	NP	CHILDREN'S
RIEFUND,	NP	RIEFUND,
AND	CC	and
WAS	VBD	be
WALKING	VVG	walk
WITH	IN	with
ONE	CD	one
OF	IN	of
THEIR	PP$	their
EMPLOYEEAN	JJ	EMPLOYEEAN
OH	UH	oh
WHEN	WRB	when
THINGT	NP	THINGT
FOR	IN	for
A.	NP	A.
AND,	NP	AND,
YEAH,	NP	YEAH,
SN,	NP	SN,
WE	PP	we
TOLD	VVD	tell
T	NN	T
IN	IN	in
THE	DT	the
HOTEL.E	NN	HOTEL.E
IS	VBZ	be
TWO	CD	two
OF,	NP	OF,
ARE	VBP	be
JUST	RB	just
WAITINGO	NP	WAITINGO
LEAVE,	NP	LEAVE,
.	SENT	.
&gt;&gt;	NN	&gt;&gt;
AS	IN	as
YOU	PP	you
,	,	,
ISRAEL	NP	Israel
HAS	VHZ	have
BEEN	VBN	be
IOUS	JJ	IOUS
TARGETS	NNS	target
IN	IN	in
IN	IN	in
RESPONSE	NN	response
TO	TO	to
THE	DT	the
HAMAS	NP	HAMAS
ING	NP	Ing
ON	NP	ON
AGAINST	IN	against
WEA	NP	WEA
A	DT	a
VERY	JJ	very
IMPOT	NP	IMPOT
AK.	NP	AK.
ELL,	NP	ELL,
WHENEVER	WRB	whenever
U	NP	U
,	,	,
KNOTHGE	NP	KNOTHGE
SOME	DT	some
VIOLENCE	NN	violence
WHILE	IN	while
YOU'RE	NP	YOU'RE
THERE.BUT,	NP	THERE.BUT,
WASN'T.	NP	WASN'T.
I	NP	I
WASN'T	NP	WASN'T
PR	NP	PR
LKNOW	NP	LKNOW
TO	TO	to
GO	VV	go
INTO	IN	into
SOME	DT	some
SHE	PP	she
WHATEVER,	NP	WHATEVER,
BAUEAR	NP	BAUEAR
THOI	NP	Thoi
R	NP	R
[	SYM	[
PLOSION]OMB	JJ	PLOSION]OMB
SHELTERS	NNS	shelter
HE	PP	he
IS	VBZ	be
THERE	RB	there
ANY	DT	any
SAFE	JJ	safe
ARETHAT	NP	ARETHAT
N	NP	N
?	SENT	?
UM,	NP	UM,
YEAH.TUTER-IN-LAW	NP	YEAH.TUTER-IN-LAW
WHO'S	NP	WHO'S
PALESTINIAN.	NP	PALESTINIAN.
SHE	PP	she
TELLS	VVZ	tell
ME	PP	me
TO	TO	to
STAY	VV	stay
AWAY	RP	away
FROM	IN	from
.	SENT	.
STAY	VV	stay
BY	IN	by
CORNERS	NNS	corner
OF	IN	of
WALLSE	NP	WALLSE
MOREO	NP	MOREO
ISRAELI	NP	Israeli
PRIME	JJ	prime
MINISTER	NN	minister
AFTER	IN	after
HAMAS,	NP	HAMAS,
IUO	NP	IUO
NOW,IKVEFORE.	NP	NOW,IKVEFORE.
HOW	WRB	how
E	NN	E
YOU	PP	you
RIGHT	RB	right
NOW	RB	now
OWN	JJ	own
SAFETY?	NP	SAFETY?
&gt;&gt;	NN	&gt;&gt;
WELL,	NP	WELL,
WE'RE	NP	WE'RE
DOINGNIZATION	NP	DOINGNIZATION
G	NP	G
HARD	JJ	hard
AND'RE	NN	AND'RE
DEVELOPING	VVG	develop
PTOO	NP	PTOO
T.	NP	T.
WE'RE	NP	WE'RE
GOING	VVG	go
ASAS	NP	ASAS
WCA&gt;&gt;	NP	WCA&gt;&gt;
YOU'RE	NP	YOU'RE
T	NN	T
EGYPT.	NP	EGYPT.
IS	VBZ	be
THAT	IN/that	that
RIGHT?	NP	RIGHT?
&gt;&gt;	NP	&gt;&gt;
RIGHT.	NP	RIGHT.
SO	IN	so
WE	PP	we
HAVE	VHP	have
TO	TO	to
GET	VV	get
VISA	NN	visa
INTO	IN	into
SO	IN	so
WE'RE	NP	WE'RE
WAI	NP	Wai
FONROYPTIAN	NP	FONROYPTIAN
IS	VBZ	be
HE	PP	he
A	DT	a
LITTLE	JJ	little
WIT	NN	wit
ISRAELIS	NPS	Israelis
WILL,	NP	WILL,
YOU	PP	you
KNOW,	NP	KNOW,
BOMB	NN	bomb
R.	NP	R.
&gt;&gt;	NN	&gt;&gt;
AS	IN	as
FAR	RB	far
ASEP	JJ	ASEP
EVACUATI,	NP	EVACUATI,
Y	NP	Y
TELLING	JJ	telling
YOTONIGHT?	NP	YOTONIGHT?
WHAT	WP	what
ARE	VBP	be
THEY	PP	they
SAYING?	JJ	SAYING?
STAY	NN	stay
PUT,	NP	PUT,
SHELTER	NN	shelter
IN	IN	in
PTRE	NN	PTRE
--	:	--
]	SYM	]
BORD	NP	Bord
LLNG	NP	LLNG
U	NP	U
OPEN,	NP	OPEN,
AND	CC	and
THENEY	NP	THENEY
GOING	VVG	go
H	NP	H
VISA.BUTHGIN	NP	VISA.BUTHGIN
ANYTHING	NN	anything
AT	IN	at
TH.	NP	TH.
I	NP	I
DON'T	NP	DON'T
THA	NP	THA
COULD.	NP	COULD.
GOT	VVD	get
GOING	VVG	go
ON.E	NN	ON.E
I	PP	I
LET	VVP	let
Y	NN	Y
&gt;&gt;	NN	&gt;&gt;
I	PP	I
GET	VVP	get
STARTLEBY	NP	STARTLEBY
THECTY	NP	THECTY
LIKE	VVP	like
?	SENT	?
HOTEL,	NP	HOTEL,
AND	CC	and
I	NP	I
F	NP	F
OUR	PP$	our
--	:	--
[	SYM	[
EXPLOSION	NN	explosion
]	SYM	]
IS	VBZ	be
SAF	NP	SAF
AR	NP	Ar
WE	PP	we
AND	CC	and
I	PP	I
JUST	RB	just
TAKE	VVP	take
</doc>	NN	</doc>
