<video_id>Re0m_Zdhc-Q</video_id>	JJ	<video_id>Re0m_Zdhc-Q</video_id>
<video_title>Graphic	JJ	<video_title>Graphic
video	NN	video
shows	VVZ	show
scale	NN	scale
of	IN	of
devastation	NN	devastation
in	IN	in
Rafah</video_title>	NP	Rafah</video_title>
<thumbnail_path>data/en_CNN\Graphic	JJ	<thumbnail_path>data/en_CNN\Graphic
video	NN	video
shows	VVZ	show
scale	NN	scale
of	IN	of
devastation	NN	devastation
in	IN	in
Rafah.jpg</thumbnail_path>	NP	Rafah.jpg</thumbnail_path>
<publish_date>20240527</publish_date>	JJ	<publish_date>20240527</publish_date>
<doc>	NN	<doc>
РЕ	NN	РЕ
ФОЛЛОВИХЕ	NN	ФОЛЛОВИХЕ
ИНТЕРНАЦИОНАЛЬНЫЙ	NN	ИНТЕРНАЦИОНАЛЬНЫЙ
ОУТР	NN	ОУТР
ЕЛИ	NN	ЕЛИ
АИРСТРАЙК	NN	АИРСТРАЙК
ЕД	NN	ЕД
ДОЗЕНС	NN	ДОЗЕНС
ДИСПЛАКЗ	NN	ДИСПЛАКЗ
ИНАФАХ.	JJ	ИНАФАХ.
Уажәы	NN	Уажәы
иара	NN	иара
дрыԥхьоит	NN	дрыԥхьоит
Е	NN	Е
РЫШЬРА	NN	РЫШЬРА
УРТ	NN	УРТ
АЦИВИЛИАЦӘА	NN	АЦИВИЛИАЦӘА
МЫ	NN	МЫ
ОНН	NN	ОНН
АТАКА	NN	АТАКА
И	NN	И
OUE	NP	Oue
S	NP	S
ДИСТУРБИНГ.	NP	ДИСТУРБИНГ.
АНТЕИР	JJ	АНТЕИР
КЛОВЬ	NN	КЛОВЬ
ОФ	NN	ОФ
ИНФОЛДИРОВЫЙ	NN	ИНФОЛДИРОВЫЙ
ХОРРОР	NN	ХОРРОР
БОЛЬШЕ	NN	БОЛЬШЕ
ЧТО	JJ	ЧТО
RD	NP	RD
ИЛШОИТ	NN	ИЛШОИТ
АХА	NN	АХА
ИТБОДИСЫ	NN	ИТБОДИСЫ
ИТЫРГЬУЕИТ	NN	ИТЫРГЬУЕИТ
ИФЕРНО	NN	ИФЕРНО
ЧТО	NN	ЧТО
ШКАЛА	NN	ШКАЛА
ЭТОТОГО	NN	ЭТОТОГО
АТАКА	NN	АТАКА
БЕМОС	NN	БЕМОС
В	NN	В
ВЕСТЕРНОЙ	NN	ВЕСТЕРНОЙ
УЕЛСЕЛОТАН	NN	УЕЛСЕЛОТАН
Б,МИСТ	NN	Б,МИСТ
ПЛАСБОТ	NN	ПЛАСБОТ
ИН	NN	ИН
ФЛЕМКРИЛС	NN	ФЛЕМКРИЛС
ТШЕТ	NN	ТШЕТ
УО	NN	УО
НИ	NN	НИ
ХХО	NN	ХХО
КОАНЕСТ	NN	КОАНЕСТ
БА	NN	БА
ОПЕРАЦИИ	NN	ОПЕРАЦИИ
,	,	,
УАХА	JJ	УАХА
ИБАЗ	JJ	ИБАЗ
РАВИЗЗЕИ	NN	РАВИЗЗЕИ
ХАЛЕДИ	NN	ХАЛЕДИ
НАГАРИ	NN	НАГАРИ
РЕДКИЙ	JJ	РЕДКИЙ
ЕЛИ''	NP	ЕЛИ''
ИМЫМХЫЗ	NN	ИМЫМХЫЗ
АХӘРАҚӘА	NN	АХӘРАҚӘА
ИРЫЗХЫРГЫЛОУЗ	NN	ИРЫЗХЫРГЫЛОУЗ
АХШЬАРА	NN	АХШЬАРА
ИШЫЗЫԥшыз	NN	ИШЫЗЫԥшыз
АЦИВИЛИАНЦӘА	NN	АЦИВИЛИАНЦӘА
НГ	NP	НГ
АБУ,	NP	АБУ,
А	JJ	А
ТАКЕАВЕЙ	NN	ТАКЕАВЕЙ
АДХЕДЛЕДИ	NN	АДХЕДЛЕДИ
ТБУХЕБА	NN	ТБУХЕБА
ИЗЫХЬЫРХЫРТЫЗ	NN	ИЗЫХЬЫРХЫРТЫЗ
КРИЕС	NN	КРИЕС
НЦЕДРХР	NN	НЦЕДРХР
АТЕВЕР	NN	АТЕВЕР
ТИНК	NN	ТИНК
СЕНС	NN	СЕНС
С	NN	С
ЕЩЕ	NN	ЕЩЕ
ХАД	NN	ХАД
СЕЙЧАС	NN	СЕЙЧАС
БЫЛ	NN	БЫЛ
ПОЛНОСТЬЮ	NN	ПОЛНОСТЬЮ
ШТЕРЕД	NN	ШТЕРЕД
МЫ	NN	МЫ
ВАНД	NN	ВАНД
ДДЕРТ	NN	ДДЕРТ
И	NN	И
ОГЕНЬ.	NP	ОГЕНЬ.
Аҳәҳәара,	NP	Аҳәҳәара,
аҩра	JJ	аҩра
иҳәоит	NN	иҳәоит
ДЕСКРИБИН	NN	ДЕСКРИБИН
РЫ	NN	РЫ
РН	NN	РН
БЕРС	NN	БЕРС
ОФ	NN	ОФ
ОРС	NN	ОРС
ЕВАКУАЦИА	NN	ЕВАКУАЦИА
ИАЛХЫЗ	NN	ИАЛХЫЗ
АЦӘЫБЖЬАҚӘА	NN	АЦӘЫБЖЬАҚӘА
РЫРН	NN	РЫРН
БЕРС	NN	БЕРС
АЕВАКУАЦИА	NN	АЕВАКУАЦИА
ЕГЬЫРТ	NN	ЕГЬЫРТ
АМАНИСОМ	NN	АМАНИСОМ
АЦЕНТРАЕ	NN	АЦЕНТРАЕ
МРАҚӘАҚӘА	JJ	МРАҚӘАҚӘА
РАФАХ,	NP	РАФАХ,
ИАРЕИТ	NN	ИАРЕИТ
АРЕА	NN	АРЕА
САИШИС	NN	САИШИС
МАНИТШЕРЕГЕЛЛТЕН.	JJ	МАНИТШЕРЕГЕЛЛТЕН.
ISWIFETYARE	NN	ISWIFETYARE
GONE	VVN	go
FOR	IN	for
ONE	CD	one
MEN	NNS	man
OF	IN	of
BROTH,	NP	BROTH,
АНТОР,	NP	АНТОР,
Е	NP	Е
АДЛИ,	NP	АДЛИ,
TH	NN	th
I	NP	I
TIME	NN	time
THAT	IN/that	that
AN	DT	an
IAELITRIT	NP	IAELITRIT
АПРЕМИТРЫЙ	NN	АПРЕМИТРЫЙ
ТАМЕ	NN	ТАМЕ
THAT	IN/that	that
IND	NP	Ind
ОФ	NP	ОФ
БЕИНГ	NP	БЕИНГ
ДОНЕХРНМЕНТ	JJ	ДОНЕХРНМЕНТ
И	NN	И
Т	NN	Т
ИЛИ	NN	ИЛИ
МИЛИТАРСКИ	NN	МИЛИТАРСКИ
ИЗРАИЛЬСКИЙ	NN	ИЗРАИЛЬСКИЙ
ПРЕМИМ-МИНИСТРЫ	JJ	ПРЕМИМ-МИНИСТРЫ
CHG	NP	CHG
ИНВЕАТСЕ	NN	ИНВЕАТСЕ
ТО	NN	ТО
ТИСТ	NN	ТИСТ
АТИНЕМ	NN	АТИНЕМ
СТ	NN	СТ
&gt;&gt;	NN	&gt;&gt;
БОРАЗМ.	NP	БОРАЗМ.
ҲАТӘЫП,	NP	ҲАТӘЫП,
НАУТА	JJ	НАУТА
У	NN	У
АФФАС	NN	АФФАС
АНАЛИСТ	NN	АНАЛИСТ
БАРАК	NN	БАРАК
РАВИД	NN	РАВИД
ОК,	NP	ОК,
Н	NP	Н
РАФАХ,	NP	РАФАХ,
АМШАШЬА	NP	АМШАШЬА
АГ	NP	АГ
ҲАЗЫХЬЫРХЫП	JJ	ҲАЗЫХЬЫРХЫП
БАХ.СУПП	NN	БАХ.СУПП
МАМЗАРА	NN	МАМЗАРА
АИШЬТА	NN	АИШЬТА
АБРЫ	NN	АБРЫ
РТ	NN	РТ
СЕРИРОЦИА	NN	СЕРИРОЦИА
АЦЕНТРҚӘА	NN	АЦЕНТРҚӘА
РЫЛШОУ	NN	РЫЛШОУ
АКЫМ	NN	АКЫМ
ЕР	NN	ЕР
РАХА	NN	РАХА
НЕТИС	NN	НЕТИС
АК.	JJ	АК.
Т	NN	Т
&gt;&gt;	NN	&gt;&gt;
БЗЫ,	NP	БЗЫ,
АКТИВНЫЙ,	NP	АКТИВНЫЙ,
СЫХӘЫРГЫЛОМ	NP	СЫХӘЫРГЫЛОМ
УАИТ	NP	УАИТ
ХАУС,	NP	ХАУС,
СЫЗЫМХЫРТЫЗ	JJ	СЫЗЫМХЫРТЫЗ
ҲАЗЫМХЫРТУАЦӘА	NN	ҲАЗЫМХЫРТУАЦӘА
TH	NN	th
HE	PP	he
W	NP	W
S	NP	S
IT'S	NP	IT'S
NOT	RB	not
JU	NP	Ju
ORDER	NN	order
TO	TO	to
KNOW	VV	know
THE	DT	the
FACTS.	NP	FACTS.
ИЗЫРКЫЛОУ	NN	ИЗЫРКЫЛОУ
АХЫРХӘЫРТҚӘА	NN	АХЫРХӘЫРТҚӘА
РИОС	NN	РИОС
TH	NN	th
T	NN	T
WHI	NP	WHI
H	NP	H
THINGNSTHAT	NP	THINGNSTHAT
АИЛАГЬЫЛОУ	JJ	АИЛАГЬЫЛОУ
ЛИНИНЕ	NN	ЛИНИНЕ
ГРУНД	NN	ГРУНД
ОПЕРАЦИА	NN	ОПЕРАЦИА
АХА	NN	АХА
АЛСОИНЦИДЕНС	NN	АЛСОИНЦИДЕНС
КАК	NN	КАК
БОМБИНА	JJ	БОМБИНА
TERDAY	NP	TERDAY
С	NN	С
РАФХЕТХИТХИО	NN	РАФХЕТХИТХИО
КАССО	NN	КАССО
ТЕ	NN	ТЕ
ХАУСТ	NN	ХАУСТ
МЕД	NN	МЕД
А	NN	А
ДЕИН	NN	ДЕИН
Анаҩстәи	NN	Анаҩстәи
,	,	,
Сгәы	JJ	Сгәы
иаанагоит,	NP	иаанагоит,
24,	CD	@card@
48	CD	@card@
СААТҚӘА	JJ	СААТҚӘА
АБРИ	JJ	АБРИ
ИАУИТ	NN	ИАУИТ
ТНТОНАЛЬНЫЙ	NN	ТНТОНАЛЬНЫЙ
УРУСТИЦА	NN	УРУСТИЦА
АШЬТЫЛА	NN	АШЬТЫЛА
МШЫЛА.	JJ	МШЫЛА.
&gt;&gt;	NN	&gt;&gt;
AS	IN	as
YOKNOW,	NP	YOKNOW,
ОРДЕР	JJ	ОРДЕР
ЕЛ	NN	ЕЛ
СТОП	NN	СТОП
ИТО	NN	ИТО
ОПЕРАЦИИ	NN	ОПЕРАЦИИ
В	NN	В
РА	NN	РА
КОНЦЕРН	NN	КОНЦЕРН
ФОР	NN	ФОР
ПАЛЕСТИНА	NN	ПАЛЕСТИНА
С	NN	С
ТЕРНАТ	NN	ТЕРНАТ
&gt;&gt;	NN	&gt;&gt;
ВЕЛ	NN	ВЕЛ
ИТ	NN	ИТ
ДЕМНТ	NN	ДЕМНТ
СЕМ	NN	СЕМ
ЧТО	NN	ЧТО
HE'S	NP	HE'S
O	NP	O
CONCERNEOU.	NP	CONCERNEOU.
ҲАЗЫХЬЫРХЬЫРТЫРТ	JJ	ҲАЗЫХЬЫРХЬЫРТЫРТ
АБРЫ	NN	АБРЫ
ЕСЫРХӘЫЛАЗ	NN	ЕСЫРХӘЫЛАЗ
ИАХЫРХЬЫРТ	NN	ИАХЫРХЬЫРТ
ИТ	JJ	ИТ
PRREO	NP	PRREO
T	NN	T
ONNC	NP	ONNC
THE	NP	THE
ON	IN	on
THE	DT	the
BIDEN	NP	Biden
TI	NP	TI
ДОМЕСТИКЛЫ	JJ	ДОМЕСТИКЛЫ
ИЗЫБЗЫКЫЗ	NN	ИЗЫБЗЫКЫЗ
АТӘЫЛАҚӘА	NN	АТӘЫЛАҚӘА
РЫЦӘЫРХРА	NN	РЫЦӘЫРХРА
АЛЛИ	JJ	АЛЛИ
ИБЗИАХӘЫРТ,	NP	ИБЗИАХӘЫРТ,
УСЫНИ	NN	УСЫНИ
БЕИКЕУЛСУЛЛСУЛСНИВС	NN	БЕИКЕУЛСУЛЛСУЛСНИВС
ИЗЫМДЫРТЫЗ.	NP	ИЗЫМДЫРТЫЗ.
АСТ	NP	АСТ
ОПЕРАЦИОНАННИНГ	NP	ОПЕРАЦИОНАННИНГ
ЛИНГ	NP	ЛИНГ
ТХА	NN	ТХА
РАФАХ	NN	РАФАХ
.	SENT	.
И	JJ	И
АПАРЕНТЛЫСТЕРДАШОУС	NN	АПАРЕНТЛЫСТЕРДАШОУС
ТХАТОУ	NN	ТХАТОУ
CA	MD	ca
ПЛАН	JJ	ПЛАН
АС	JJ	АС
МУЧ	NN	МУЧ
АС	NN	АС
YOU	PP	you
WANTBUT	NP	WANTBUT
АНИ	NN	АНИ
ДӘАЦӘОИТ	NN	ДӘАЦӘОИТ
АЕА	NN	АЕА
РАФАХ	NN	РАФАХ
ИЛЫПКЫЗ	NN	ИЛЫПКЫЗ
ДЕНСЛЕ	NN	ДЕНСЛЕ
ПОПУЛИРОВАННЫЙ	NN	ПОПУЛИРОВАННЫЙ
ПЛА	NN	ПЛА
ПЛАН	NN	ПЛАН
ИЗБЫРТЫЗ	NN	ИЗБЫРТЫЗ
Е	NN	Е
С	NN	С
ШӘАРА	NN	ШӘАРА
ИШӘЫЛШОИТ	NN	ИШӘЫЛШОИТ
CAUSEEW	NP	CAUSEEW
ҴАХЫ.	NP	ҴАХЫ.
&gt;&gt;	NN	&gt;&gt;
SO	IN	so
BARAK	NP	Barak
DO	VVP	do
THINK	VV	think
THIS	DT	this
RI	NP	RI
IAU	NP	IAU
АВЕРЕ	NN	АВЕРЕ
ТХАТТ	NN	ТХАТТ
СПЕАСС	JJ	СПЕАСС
БЗЫЛА,	NP	БЗЫЛА,
FIRS	NNS	fir
СЕНТ	NN	СЕНТ
ЕТ	NN	ЕТ
МЕ	NN	МЕ
СПИКЕР	NN	СПИКЕР
ЏЬОНСОН	JJ	ЏЬОНСОН
СА'	NP	СА'
АТТО	NN	АТТО
СЫ	NN	СЫ
ДОНТ	JJ	ДОНТ
THN	NP	THN
ИНФЛУЕНЦИЯ	NN	ИНФЛУЕНЦИЯ
ОН	NN	ОН
ТХЕБ	NN	ТХЕБ
СЫДУМАЮ	NN	СЫДУМАЮ
ИТО	NN	ИТО
Е	NN	Е
АКТУАЛЬНО	NN	АКТУАЛЬНО
ИДЕФТКЕФТИРС1	JJ	ИДЕФТКЕФТИРС1
ХИНК	NN	ХИНК
УЕ	NN	УЕ
МЕ	NN	МЕ
ОМ	NN	ОМ
&gt;&gt;	NN	&gt;&gt;
БАРАК	JJ	БАРАК
РАВИД,	NP	РАВИД,
П	NN	П
</doc>	NN	</doc>
