&	CC	&
gt	NN	gt
;	:	;
&	CC	&
gt	NN	gt
;	:	;
&	CC	&
gt	NN	gt
;	:	;
ҲАРА	JJ	ҲАРА
ҲАЦӘЫРГЫЛАЗ	NN	ҲАЦӘЫРГЫЛАЗ
,	,	,
ШӘАГЬЫРГЬЫРТ	JJ	ШӘАГЬЫРГЬЫРТ
,	,	,
АБРИ	JJ	АБРИ
ИАХӘЫРХӘЫРТ	JJ	ИАХӘЫРХӘЫРТ
АХӘТӘЫЛА	NN	АХӘТӘЫЛА
АХӘТӘЫЛА	NN	АХӘТӘЫЛА
АХӘТӘЫЛА	NN	АХӘТӘЫЛА
АХӘТӘЫЛА	NN	АХӘТӘЫЛА
ИУСЫР	NN	ИУСЫР
АХӘТӘЫР	NN	АХӘТӘЫР
АШЬТЫРТ	NN	АШЬТЫРТ
,	,	,
ИАШЬТЫРТЫЗ	JJ	ИАШЬТЫРТЫЗ
АЗХЫРХӘЫРА	NN	АЗХЫРХӘЫРА
.	SENT	.
ҲАРА	JJ	ҲАРА
Еиҳаны	JJ	Еиҳаны
иаҳдыруеит	NN	иаҳдыруеит
иҟалаз	NN	иҟалаз
TANOH	NP	TANOH
VOIR	FW	voir
DIRE	FW	dire
MUSIC	NN	music
TEST	NN	test
VALUE	NN	value
,	,	,
260	CD	@card@
АУАА	NN	АУАА
ҲЫРХЫЗ	NN	ҲЫРХЫЗ
ИАХЫРХЬЫЗ	NN	ИАХЫРХЬЫЗ
,	,	,
АБРЫ	JJ	АБРЫ
АТЕРРОРСТӘ	JJ	АТЕРРОРСТӘ
ҬАКАКАҚӘА	NN	ҬАКАКАҚӘА
РЫЛА	NN	РЫЛА
ЗЫЗКЫЗ	NN	ЗЫЗКЫЗ
АТАКА	NN	АТАКА
ҟаҵоуп	NN	ҟаҵоуп
.	SENT	.
ИЗРАИЛЬТӘИ	JJ	ИЗРАИЛЬТӘИ
АХЫхьчаратә	JJ	АХЫхьчаратә
мчқәа	NN	мчқәа
СЫРГЫЛЕИТ	NN	СЫРГЫЛЕИТ
АПЫРХӘЫЛАРАҚӘА	NN	АПЫРХӘЫЛАРАҚӘА
,	,	,
АШЬРАҚӘАҚӘА	JJ	АШЬРАҚӘАҚӘА
ИАХЫРГЬЫЛОУ	JJ	ИАХЫРГЬЫЛОУ
Аҭыԥ	NN	Аҭыԥ
ахь	NN	ахь
.	SENT	.
&	CC	&
gt	NN	gt
;	:	;
&	CC	&
gt	NN	gt
;	:	;
АМУЗЫКА	JJ	АМУЗЫКА
ИАРҲӘОУАН	NN	ИАРҲӘОУАН
,	,	,
АКӘШӘАРА	JJ	АКӘШӘАРА
ҴЫРТ	NN	ҴЫРТ
,	,	,
АРОКЕТАҚӘА	JJ	АРОКЕТАҚӘА
РЫЛАГЬЫЗ	NN	РЫЛАГЬЫЗ
.	SENT	.
ГАЗА	JJ	ГАЗА
АҲӘА	NN	АҲӘА
Аҟынтә	NN	Аҟынтә
3	CD	@card@
,	,	,
3	CD	@card@
МИЛЬ	NN	МИЛЬ
ЗАКЫЗ	NN	ЗАКЫЗ
.	SENT	.
ҲАМАС	JJ	ҲАМАС
АБџьар	JJ	АБџьар
зкыз	NN	зкыз
ауаа	NN	ауаа
раара	NN	раара
хара	NN	хара
имгаӡеит	NN	имгаӡеит
АПАРТИА	NN	АПАРТИА
ИЦӘАЗ	NN	ИЦӘАЗ
Џьоукы	NN	Џьоукы
РМАШЬЫНАҚӘА	NN	РМАШЬЫНАҚӘА
РЫНТӘЫРТ	NN	РЫНТӘЫРТ
,	,	,
АХА	JJ	АХА
Аӡәырҩы	JJ	Аӡәырҩы
ҴЫРХЫРТЫРТ	NN	ҴЫРХЫРТЫРТ
&	CC	&
gt	NN	gt
;	:	;
&	CC	&
gt	NN	gt
;	:	;
КОНТР	JJ	КОНТР
-	NN	-
АДМИРАЛ	NN	АДМИРАЛ
ДАНИЕЛЬ	NN	ДАНИЕЛЬ
ҲАГАРИ	NN	ҲАГАРИ
,	,	,
ИПЫСХЫРТЫРТЫЗ	JJ	ИПЫСХЫРТЫРТЫЗ
АСОЛДАЦИА	NN	АСОЛДАЦИА
,	,	,
АБРИ	JJ	АБРИ
АИС	JJ	АИС
АКЫЗ	NN	АКЫЗ
ЗЫМБАЗ	NN	ЗЫМБАЗ
&	CC	&
gt	NN	gt
;	:	;
&	CC	&
gt	NN	gt
;	:	;
АБРИ	JJ	АБРИ
МАССАКР	NN	МАССАКР
СЦЕНАУП	NN	СЦЕНАУП
.	SENT	.
ИЗРАИЛЬ	JJ	ИЗРАИЛЬ
АТАРИХ	NN	АТАРИХ
Аҿы	NN	Аҿы
,	,	,
ИШЫШЬТЫЛАЗ	JJ	ИШЫШЬТЫЛАЗ
,	,	,
АБРЫ	JJ	АБРЫ
АХКЫ	JJ	АХКЫ
АХЫСХЫРТ	NN	АХЫСХЫРТ
АЗЫ	NN	АЗЫ
ДАГЬЫЗ	NN	ДАГЬЫЗ
АГЫЛАШЬРА	NN	АГЫЛАШЬРА
СЫМАМ	NN	СЫМАМ
&	CC	&
gt	NN	gt
;	:	;
&	CC	&
gt	NN	gt
;	:	;
ИПСЫЗ	JJ	ИПСЫЗ
РЫЦӘЫБЖЬАҚӘА	NN	РЫЦӘЫБЖЬАҚӘА
,	,	,
РЫЦӘЫБЖЬА	JJ	РЫЦӘЫБЖЬА
ХӘТҚӘАҚӘА	JJ	ХӘТҚӘАҚӘА
РЫЛХЫРТ	NN	РЫЛХЫРТ
,	,	,
АХА	JJ	АХА
АУАА	JJ	АУАА
РМАЛАҚӘА	NN	РМАЛАҚӘА
ЗЕИКЫРТЫЗ	NN	ЗЕИКЫРТЫЗ
.	SENT	.
АШЬРА	JJ	АШЬРА
ЕИЛКУП	NN	ЕИЛКУП
.	SENT	.
ИБЛЫЗ	JJ	ИБЛЫЗ
АМАШЬЫНАҚӘА	NN	АМАШЬЫНАҚӘА
,	,	,
ИБЛЫЛЫЗ	JJ	ИБЛЫЛЫЗ
АМАШЬЫНАҚӘА	NN	АМАШЬЫНАҚӘА
,	,	,
АХЫМТӘЫЛАҚӘА	JJ	АХЫМТӘЫЛАҚӘА
,	,	,
АТӘЫРҚӘА	JJ	АТӘЫРҚӘА
РЫЛА	JJ	РЫЛА
АШЬА	NN	АШЬА
ЗЫМАШЬЫНАҚӘА	NN	ЗЫМАШЬЫНАҚӘА
РЫЛА	NN	РЫЛА
ИДФ	NN	ИДФ
ИАХЫРГЫЛЕИТ	NN	ИАХЫРГЫЛЕИТ
ДАШ	NN	ДАШ
КАМ	NN	КАМ
АВИДЕОҚӘА	NN	АВИДЕОҚӘА
,	,	,
ҲАМАС	JJ	ҲАМАС
Бџьар	JJ	Бџьар
зкуа	NN	зкуа
СААТҚӘА	NN	СААТҚӘА
РЫЛА	NN	РЫЛА
САИТ	NN	САИТ
Аҿы	NN	Аҿы
ишнеиуа	NN	ишнеиуа
атәы	NN	атәы
.	SENT	.
АБРИ	JJ	АБРИ
ИААРБОИТ	JJ	ИААРБОИТ
АШЬА	NN	АШЬА
ЗЫЛАЗ	NN	ЗЫЛАЗ
АТАК	NN	АТАК
ДШЫРГЬЫРГЬО	NN	ДШЫРГЬЫРГЬО
.	SENT	.
АМАШЬЫНА	JJ	АМАШЬЫНА
ҴАҚӘА	JJ	ҴАҚӘА
ДУБОИТ	NN	ДУБОИТ
ДАГЬЫЗ	NN	ДАГЬЫЗ
АХАДАК	NN	АХАДАК
ДЫЗЫМХЫРХЫЗ	NN	ДЫЗЫМХЫРХЫЗ
.	SENT	.
Бџьар	JJ	Бџьар
зкыз	JJ	зкыз
ауаҩы	NN	ауаҩы
дыҩны	NN	дыҩны
днеиуеит	NN	днеиуеит
,	,	,
насгьы	JJ	насгьы
ихы	JJ	ихы
ма	NN	ма
ицәеижь	NN	ицәеижь
хыхьтәи	NN	хыхьтәи
ахәҭаҿы	NN	ахәҭаҿы
дихысуеит	NN	дихысуеит
.	SENT	.
&	CC	&
gt	NN	gt
;	:	;
&	CC	&
gt	NN	gt
;	:	;
САРА	JJ	САРА
ИЗДЫРДАМ	JJ	ИЗДЫРДАМ
АУАА	NN	АУАА
АБРИ	NN	АБРИ
ИШЫРЫЛШО	NN	ИШЫРЫЛШО
.	SENT	.
СЫЛШОМ	JJ	СЫЛШОМ
-	NN	-
-	NN	-
ИСЫМАМ	NN	ИСЫМАМ
АЖӘАҚӘА	NN	АЖӘАҚӘА
ИЗЫЛСЫРКЫЗ	NN	ИЗЫЛСЫРКЫЗ
.	SENT	.
АШЬТЫРТ	JJ	АШЬТЫРТ
АМОТОЦИКЛ	JJ	АМОТОЦИКЛ
АЛА	NN	АЛА
АБЫНАЛА	NN	АБЫНАЛА
Аӡӷабцәа	NN	Аӡӷабцәа
рыцны	NN	рыцны
ГАЗА	NN	ГАЗА
Аҟынӡа	NN	Аҟынӡа
.	SENT	.
&	CC	&
gt	NN	gt
;	:	;
&	CC	&
gt	NN	gt
;	:	;
МРАГЬАЛА	JJ	МРАГЬАЛА
АМТЫЛА	JJ	АМТЫЛА
ИАРТУ	NN	ИАРТУ
АМХЫРТҚӘА	NN	АМХЫРТҚӘА
РЫЛА	NN	РЫЛА
АБНАРА	NN	АБНАРА
Аӡәырҩы	NN	Аӡәырҩы
рзы	NN	рзы
амҩа	NN	амҩа
заҵәык	NN	заҵәык
акәын	NN	акәын
,	,	,
АХА	JJ	АХА
УРТ	JJ	УРТ
ИМАРГЬЫЗ	NN	ИМАРГЬЫЗ
АХЫҚӘКЫ	NN	АХЫҚӘКЫ
ПЛЮС	NN	ПЛЮС
.	SENT	.
ЕГЬЫРТ	JJ	ЕГЬЫРТ
АЗААИГЫЗ	JJ	АЗААИГЫЗ
АБОМБАҚӘА	NN	АБОМБАҚӘА
РЫЗЫХЫРХӘЫЗ	NN	РЫЗЫХЫРХӘЫЗ
Аҭыԥқәа	NN	Аҭыԥқәа
рҿы	NN	рҿы
ашәарҭадара	NN	ашәарҭадара
рыԥшаауан	NN	рыԥшаауан
АБРИ	NN	АБРИ
ДАШ	NN	ДАШ
КАМ	NN	КАМ
ВИДЕО	NN	ВИДЕО
ҲАМАС	NN	ҲАМАС
АБЗЫР	NN	АБЗЫР
ЗКЫЗ	NN	ЗКЫЗ
АХЫРХЫРТӘЫЛА	NN	АХЫРХЫРТӘЫЛА
АГРЕНАТА	NN	АГРЕНАТА
ДЫЛАШЬТОУП	NN	ДЫЛАШЬТОУП
,	,	,
АХАЗА	JJ	АХАЗА
ДЫБНАЛАЗ	JJ	ДЫБНАЛАЗ
ДЫБНЫЛОЗ	NN	ДЫБНЫЛОЗ
,	,	,
ЗЫНЫМТӘЫЛА	JJ	ЗЫНЫМТӘЫЛА
ИТЫРХЫРТ	NN	ИТЫРХЫРТ
.	SENT	.
АФЕСТИВАЛЬ	JJ	АФЕСТИВАЛЬ
АҚӘЫРГЫЛОУ	JJ	АҚӘЫРГЫЛОУ
Аҭыԥ	NN	Аҭыԥ
Аҩадаҟа	NN	Аҩадаҟа
КИЛЬМИ	NN	КИЛЬМИ
ЗАКЫЛА	NN	ЗАКЫЛА
Иҟоу	NN	Иҟоу
ДАГЬЫЛАК	NN	ДАГЬЫЛАК
Аҿы	NN	Аҿы
30	CD	@card@
-	NN	-
ҩык	NN	ҩык
раҟара	NN	раҟара
ауаа	NN	ауаа
рҽырҵәахырц	NN	рҽырҵәахырц
рҽазыршәеит	NN	рҽазыршәеит
.	SENT	.
Аҩныҵҟа	JJ	Аҩныҵҟа
иҭаҩу	NN	иҭаҩу
АХАЗ	NN	АХАЗ
.	SENT	.
РБЫҚӘА	JJ	РБЫҚӘА
АПАНИКА	NN	АПАНИКА
УАҲӘОИТ	NN	УАҲӘОИТ
,	,	,
Иҟалозеи	JJ	Иҟалозеи
,	,	,
ИЗРАИЛИАТӘИ	JJ	ИЗРАИЛИАТӘИ
ААРДАЦӘА	JJ	ААРДАЦӘА
Рааигәара	NN	Рааигәара
иҟоума	NN	иҟоума
ҳәа	NN	ҳәа
иразҵаауеит	NN	иразҵаауеит
.	SENT	.
Анаҩс	JJ	Анаҩс
иҟалаз	NN	иҟалаз
шәҳарбаӡом	NN	шәҳарбаӡом
.	SENT	.
КОХЕН	JJ	КОХЕН
ИАҲӘОИТ	NN	ИАҲӘОИТ
,	,	,
ҲАМАС	JJ	ҲАМАС
ибџьаршьҭыхҩцәа	JJ	ибџьаршьҭыхҩцәа
зныкымкәа	NN	зныкымкәа
-	NN	-
ҩынтәымкәа	NN	ҩынтәымкәа
агранатақәа	NN	агранатақәа
ахыҵакырҭаҿы	NN	ахыҵакырҭаҿы
иршәит	NN	иршәит
.	SENT	.
Аҩныҵҟа	JJ	Аҩныҵҟа
иҭаз	JJ	иҭаз
Ауаа	NN	Ауаа
ЕИПЫРТЫРТ	NN	ЕИПЫРТЫРТ
.	SENT	.
АРИ	JJ	АРИ
ЗЫМХЫРТЫЗ	JJ	ЗЫМХЫРТЫЗ
АВИДЕОҚӘА	NN	АВИДЕОҚӘА
РЫЛА	NN	РЫЛА
АКУП	NN	АКУП
.	SENT	.
АБРИ	JJ	АБРИ
АМАТЕМАТИКА	JJ	АМАТЕМАТИКА
АШЬТЫЛА	NN	АШЬТЫЛА
ИЗЫМХЫРТЫЗ	NN	ИЗЫМХЫРТЫЗ
ЗЫКУП	NN	ЗЫКУП
.	SENT	.
КОХЕН	JJ	КОХЕН
ДЫЛХЫРТ	NN	ДЫЛХЫРТ
,	,	,
ИЦӘЕИБЖЬА	JJ	ИЦӘЕИБЖЬА
ХӘТӘҚӘА	JJ	ХӘТӘҚӘА
РЫҴАҚӘА	NN	РЫҴАҚӘА
ДЫЗХЫРХЬЫЗ	NN	ДЫЗХЫРХЬЫЗ
.	SENT	.
УБРИ	JJ	УБРИ
ИАРА	NN	ИАРА
ИОУП	NN	ИОУП
,	,	,
ДШӘОУП	JJ	ДШӘОУП
,	,	,
АХА	JJ	АХА
ИБЗЫЗ	NN	ИБЗЫЗ
.	SENT	.
АХЫРХЫРТ	JJ	АХЫРХЫРТ
АҚАЛАҚЬ	JJ	АҚАЛАҚЬ
Аҿы	NN	Аҿы
иҳаԥшааит	NN	иҳаԥшааит
ҴАХӘЫЛА	NN	ҴАХӘЫЛА
.	SENT	.
АШЬА	JJ	АШЬА
АХЫРХӘЫ	JJ	АХЫРХӘЫ
АХЫРХӘЫ	NN	АХЫРХӘЫ
ИХЫРХЫРТ	NN	ИХЫРХЫРТ
,	,	,
АХА	JJ	АХА
УАНТАЛАЗ	JJ	УАНТАЛАЗ
АФЫР	NN	АФЫР
АКЫ	NN	АКЫ
ИЛЫМХЫРТЫЗ	NN	ИЛЫМХЫРТЫЗ
САКАМЕРА	NN	САКАМЕРА
,	,	,
АИБАШЬРА	JJ	АИБАШЬРА
АКЫЗ	JJ	АКЫЗ
ИХЫРГЫЗ	NN	ИХЫРГЫЗ
,	,	,
ДЫЛАГЫЛОИТ	JJ	ДЫЛАГЫЛОИТ
,	,	,
Адәахьы	JJ	Адәахьы
ддәылҵыр	JJ	ддәылҵыр
акәхеит	NN	акәхеит
.	SENT	.
Аҭӡамц	JJ	Аҭӡамц
аҿы	JJ	аҿы
ашьа	NN	ашьа
зқәу	NN	зқәу
анапқәа	NN	анапқәа
рышьҭақәа	NN	рышьҭақәа
ыҟоуп	NN	ыҟоуп
.	SENT	.
Аҭӡамцқәа	JJ	Аҭӡамцқәа
рҿы	JJ	рҿы
ашьа	NN	ашьа
ҟьашьуп	NN	ҟьашьуп
.	SENT	.
Шәара	JJ	Шәара
ишәбар	NN	ишәбар
шәылшоит	NN	шәылшоит
,	,	,
АРБАРТ	JJ	АРБАРТ
АБУЛЛЕТ	JJ	АБУЛЛЕТ
АТӘЫЛАҚӘА	NN	АТӘЫЛАҚӘА
,	,	,
МАМЗАР	JJ	МАМЗАР
АБАРА	JJ	АБАРА
ИТЫРЦЫЗ	NN	ИТЫРЦЫЗ
АГРАНАТАҚӘА	NN	АГРАНАТАҚӘА
РЫЛКЫЗ	NN	РЫЛКЫЗ
АБРАНТӘИ	NN	АБРАНТӘИ
АЦӘЕИХ	NN	АЦӘЕИХ
ХӘТӘТҚӘА	NN	ХӘТӘТҚӘА
РЕИГЫЛТ	NN	РЕИГЫЛТ
,	,	,
АХА	JJ	АХА
ШЬАЛА	JJ	ШЬАЛА
ИЗЫЛАКЫЗ	NN	ИЗЫЛАКЫЗ
АМАТҚӘА	NN	АМАТҚӘА
,	,	,
АШЬАМАҚӘА	JJ	АШЬАМАҚӘА
РЫЗХЫРГЫЛОУП	NN	РЫЗХЫРГЫЛОУП
.	SENT	.
АБРИ	JJ	АБРИ
ШЬА	JJ	ШЬА
ЗЛЫЛШОУ	NN	ЗЛЫЛШОУ
НАПЫ	NN	НАПЫ
АШЬЫПЫРТ	NN	АШЬЫПЫРТ
АБРИ	NN	АБРИ
АХЫРХЫРТ	NN	АХЫРХЫРТ
15	CD	@card@
ФУТ	NN	ФУТ
ЕИҲАМ	NN	ЕИҲАМ
,	,	,
Иҟалап	NN	Иҟалап
5	CD	@card@
1	CD	@card@
/	SYM	/
2	CD	@card@
,	,	,
6	CD	@card@
ФУТ	NN	ФУТ
АШЬАРА	NN	АШЬАРА
.	SENT	.
АБРЫ	JJ	АБРЫ
ИАДЫРГЫЛОУ	JJ	ИАДЫРГЫЛОУ
АУАА	NN	АУАА
РЫДЕИА	NN	РЫДЕИА
,	,	,
ИГЫЛАГЬЫЛОУ	JJ	ИГЫЛАГЬЫЛОУ
,	,	,
ИШӘЫРГЬЫЛОУ	JJ	ИШӘЫРГЬЫЛОУ
,	,	,
ИҚӘЫРГЬЫЛОУ	JJ	ИҚӘЫРГЬЫЛОУ
,	,	,
ИЗЫМАХӘЫРТ	JJ	ИЗЫМАХӘЫРТ
АДЫЗГЫЛШО	JJ	АДЫЗГЫЛШО
АДЫЗХЫРХЫЗ	NN	АДЫЗХЫРХЫЗ
Иҟоуп	NN	Иҟоуп
АБРИ	NN	АБРИ
АБРИ	NN	АБРИ
АБРЫ	NN	АБРЫ
АХЫРХЫРТҚӘА	NN	АХЫРХЫРТҚӘА
,	,	,
ЕГЬЫРТ	JJ	ЕГЬЫРТ
АТРАГЕДИАҚӘА	NN	АТРАГЕДИАҚӘА
,	,	,
ИАЗЫРТЫЗ	NN	ИАЗЫРТЫЗ
.	SENT	.
АХОРРО	JJ	АХОРРО
НЫЗКЫЗ	NN	НЫЗКЫЗ
