<video_id>hH8eMkO1CpA</video_id>	JJ	<video_id>hH8eMkO1CpA</video_id>
<video_title>How	NN	<video_title>How
Hamas	NNS	Hamas
surpise	VVP	surpise
attack	NN	attack
on	IN	on
Israel	NP	Israel
unfolded</video_title>	JJ	unfolded</video_title>
<thumbnail_path>data/en_CNN\How	NN	<thumbnail_path>data/en_CNN\How
Hamas	NNS	Hamas
surpise	VVP	surpise
attack	NN	attack
on	IN	on
Israel	NP	Israel
unfolded.jpg</thumbnail_path>	JJ	unfolded.jpg</thumbnail_path>
<publish_date>20231009</publish_date>	NN	<publish_date>20231009</publish_date>
<doc>	NN	<doc>
Агәыӷра	NN	Агәыӷра
сымоуп	JJ	сымоуп
урҭ	NP	урҭ
ақҭаб	NN	ақҭаб
7	CD	@card@
азы	NN	азы
шьыжьымҭан	NN	шьыжьымҭан
иаауеит	NN	иаауеит
ҳәа.	JJ	ҳәа.
Газа	NN	Газа
иҟоу	NN	иҟоу
апалестинатә	NN	апалестинатә
еибашьцәа	NN	еибашьцәа
Израильҟа	NN	Израильҟа
зықьҩыла	NN	зықьҩыла
аракетақәа	JJ	аракетақәа
дыршәит,	NP	дыршәит,
ҳәа	NN	ҳәа
рҳәоит	NN	рҳәоит
Израильтәи	NN	Израильтәи
арратә	NN	арратә
усбарҭақәа.	NP	усбарҭақәа.
Убри	NP	Убри
аан,	NP	аан,
ажәылара	NP	ажәылара
мҩаԥысуанаҵы,	NP	мҩаԥысуанаҵы,
Газаҟынтәи	JJ	Газаҟынтәи
Израильтәи	NN	Израильтәи
атәылаҿацә	NN	атәылаҿацә
ахь	NN	ахь
абџьар	NN	абџьар
зкыз	NN	зкыз
ауаа	NN	ауаа
ҭыԥқәак	NN	ҭыԥқәак
рҿы	NN	рҿы
аҭалара	NN	аҭалара
иалагеит	NN	иалагеит
.	SENT	.
Тель-Авиви	JJ	Тель-Авиви
Иерусалимҟынӡа	JJ	Иерусалимҟынӡа
сааҭла	NN	сааҭла
асиренақәа	NN	асиренақәа
рыбжьы	NN	рыбжьы
гон	NN	гон
.	SENT	.
Газа	JJ	Газа
напхгара	JJ	напхгара
азҭо	NN	азҭо
Палестинатәи	NN	Палестинатәи
аибашьцәа	NN	аибашьцәа
реиҿкаара	NN	реиҿкаара
Ҳамас	NN	Ҳамас
аҭакԥхықәра	NN	аҭакԥхықәра
ахахьы	NN	ахахьы
иагеит.	NP	иагеит.
Урҭ	NP	Урҭ
изларҳәо	NP	изларҳәо
ала,	NP	ала,
аамҭа	JJ	аамҭа
кьаҿк	NN	кьаҿк
иалагӡаны	NN	иалагӡаны
аҳәса	NN	аҳәса
рықәлара	NN	рықәлара
рҭак	NN	рҭак
ҟарҵон.	JJ	ҟарҵон.
Иерусалимтәи	NN	Иерусалимтәи
аԥшьаныҳәарҭа	NN	аԥшьаныҳәарҭа
Аль-Ақса	NN	Аль-Ақса
аҿы	NN	аҿы
имҩаԥысуа	JJ	имҩаԥысуа
аусмҩаԥгатәқәеи,	NP	аусмҩаԥгатәқәеи,
имҩаԥысуа	NN	имҩаԥысуа
Газа	NN	Газа
акәшареи.	JJ	акәшареи.
Аҭакс.	JJ	Аҭакс.
Израильтәи	NN	Израильтәи
ахьчаратә	NN	ахьчаратә
мчқәа	NN	мчқәа
иҟарҵаз	NN	иҟарҵаз
адыррақәа	JJ	адыррақәа
рыла,	NP	рыла,
Газа	NN	Газа
иҟоу	NN	иҟоу
Ҳамас	NN	Ҳамас
ахықәкқәа	NN	ахықәкқәа
рҟны	NN	рҟны
ақәылара	JJ	ақәылара
мҩаԥыргеит,	NP	мҩаԥыргеит,
насгьы	NN	насгьы
зықьҩыла	NN	зықьҩыла
арезервтә	NN	арезервтә
мчқәа	NN	мчқәа
рахь	NN	рахь
ааԥхьара	JJ	ааԥхьара
ҟарҵеит,	NP	ҟарҵеит,
аракетақәа	NN	аракетақәа
рықәҵра	NN	рықәҵра
ахьцоз	NN	ахьцоз
азы.	JJ	азы.
Газаҟынтәи	NN	Газаҟынтәи
авидеоқәа	NN	авидеоқәа
цәырҵуа	NN	цәырҵуа
иалагеит	NN	иалагеит
,	,	,
Палестина	JJ	Палестина
ауааԥсыра	JJ	ауааԥсыра
аныҳәа	NN	аныҳәа
шыргәарҭоз	NN	шыргәарҭоз
аазырԥшуазшәа.	JJ	аазырԥшуазшәа.
Реутерс	NN	Реутерс
иҭнажьыз	NN	иҭнажьыз
видеок	NN	видеок
аҿы	NN	аҿы
иааԥшуеит	NN	иааԥшуеит
Палестинатәи	NN	Палестинатәи
аибашьцәа	NN	аибашьцәа
Газа	NN	Газа
агәараҿы	NN	агәараҿы
израильтәи	NN	израильтәи
аруаҩ	NN	аруаҩ
атанк	NN	атанк
дҭырго	NN	дҭырго
.	SENT	.
Ҳамас	JJ	Ҳамас
израильтәи	JJ	израильтәи
аруаа	NN	аруаа
ԥыҭҩык	NN	ԥыҭҩык
ҭаркит	NN	ҭаркит
ҳәа	NN	ҳәа
рҳәеит.	JJ	рҳәеит.
Израильтәи	NN	Израильтәи
арратә	NN	арратә
усбарҭақәа	JJ	усбарҭақәа
ирҳәеит,	NP	ирҳәеит,
Ҳамас	NN	Ҳамас
шаҟаҩы	NN	шаҟаҩы
ауаа	NN	ауаа
ҭаркыз	NN	ҭаркыз
еилыркааӡакәа.	NP	еилыркааӡакәа.
IDF	NP	IDF
иара	NP	иара
убасгьы	NP	убасгьы
иазгәанаҭеит,	NP	иазгәанаҭеит,
Газа	JJ	Газа
аҳәаа	NN	аҳәаа
азааигәара	NN	азааигәара
иҟоу	NN	иҟоу
Израильтәи	NN	Израильтәи
ақалақьқәа	NN	ақалақьқәа
рҿы	NN	рҿы
ақәылацәа	NN	ақәылацәа
ԥыҭҩык	NN	ԥыҭҩык
ҭакрада	NN	ҭакрада
ишырку.	JJ	ишырку.
Иҭахаз	NN	Иҭахаз
рхыԥхьаӡара	NN	рхыԥхьаӡара
еизҳацыԥхьаӡа.	JJ	еизҳацыԥхьаӡа.
Ари	NN	Ари
Израильтәи-Палестинатәи	NN	Израильтәи-Палестинатәи
аиҿагылараҿы	NN	аиҿагылараҿы
зегь	NN	зегь
реиҳа	NN	реиҳа
ихьанҭоу	NN	ихьанҭоу
аескалациақәа	NN	аескалациақәа
иреиуоуп	NN	иреиуоуп
Уи	NN	Уи
ҟалеит	NN	ҟалеит
1973	CD	@card@
ашықәс	NN	ашықәс
азы	NN	азы
Арабтә	NN	Арабтә
ҳәынҭқаррақәа	NN	ҳәынҭқаррақәа
Израиль	NN	Израиль
аибашьра	NN	аибашьра
аныҟала	JJ	аныҟала
50	CD	@card@
шықәса	JJ	шықәса
анырхыҵуаз,	NP	анырхыҵуаз,
аиудеиаа	NN	аиудеиаа
рымҳәырԥхьаӡагаҿы	NN	рымҳәырԥхьаӡагаҿы
иреиҳа	NN	иреиҳа
иԥшьоу	NN	иԥшьоу
амш	NN	амш
Иом	NN	Иом
Кипур	NN	Кипур
аҽны	NN	аҽны
Ари	NN	Ари
амчыбжь	NN	амчыбжь
анҵәамҭагьы	NN	анҵәамҭагьы
аиудеиаа	NN	аиудеиаа
рныҳәоуп.	NP	рныҳәоуп.
Сабиҳа	NP	Сабиҳа
Тора,	NP	Тора,
Газа	NN	Газа
2	CD	@card@
миллионҩык	NN	миллионҩык
ауаа	JJ	ауаа
зқәынхо,	NP	зқәынхо,
Ҳамас	NN	Ҳамас
анапхгара	NN	анапхгара
аҵаҟа	NN	аҵаҟа
иҟоу	NN	иҟоу
140	CD	@card@
миль	NN	миль
квадраттә	NN	квадраттә
ҭыԥ	NN	ҭыԥ
аҿы	NN	аҿы
еизаны	NN	еизаны
иҟоу	NN	иҟоу
амшын	NN	амшын
аԥшаҳәаҿы	NN	аԥшаҳәаҿы
иҟоу	NN	иҟоу
анклавуп	NN	анклавуп
2007	CD	@card@
шықәсазы	NN	шықәсазы
Израиль	NN	Израиль
Газа	NN	Газа
адгьыл,	NP	адгьыл,
аҳауа,	NP	аҳауа,
амшын	JJ	амшын
аблокада	NN	аблокада
абзоурала	NN	абзоурала
адунеи	NN	адунеи
зегьы	NN	зегьы
иацәыхараны	NN	иацәыхараны
иҟоуп	NN	иҟоуп
Израиль	NN	Израиль
атәылауаа	NN	атәылауаа
рныҟәара	NN	рныҟәара
ахақәиҭразы	NN	ахақәиҭразы
аԥкрақәа	NN	аԥкрақәа
ӷәӷәа	JJ	ӷәӷәа
шьақәнаргылеит,	NP	шьақәнаргылеит,
амшын	NN	амшын
аԥшаҳәа	NN	аԥшаҳәа
ҭшәахь	NN	ҭшәахь
ихадароу	NN	ихадароу
амаҭәахәқәа	NN	амаҭәахәқәа
раагара	NN	раагара
ахылаԥшра	NN	ахылаԥшра
мҩаԥнагоит.	JJ	мҩаԥнагоит.
Зқьҩыла	NN	Зқьҩыла
аусзуҩцәа	NN	аусзуҩцәа
азин	NN	азин
змоу	NN	змоу
есыҽны	NN	есыҽны
Израильҟа	NN	Израильҟа
ишнеиуазгьы.	JJ	ишнеиуазгьы.
</doc>	NN	</doc>
