<video_id>XCr6NkCZK9A</video_id>	JJ	<video_id>XCr6NkCZK9A</video_id>
<video_title>How	NN	<video_title>How
Israel	NP	Israel
is	VBZ	be
responding	VVG	respond
to	TO	to
Hamas	JJ	Hamas
attacks	NNS	attack
with	IN	with
‘siege’	NN	‘siege’
on	IN	on
Gaza</video_title>	NP	Gaza</video_title>
<thumbnail_path>data/en_CNN\How	NP	<thumbnail_path>data/en_CNN\How
Israel	NP	Israel
is	VBZ	be
responding	VVG	respond
to	TO	to
Hamas	JJ	Hamas
attacks	NNS	attack
with	IN	with
‘siege’	NN	‘siege’
on	IN	on
Gaza.jpg</thumbnail_path>	NP	Gaza.jpg</thumbnail_path>
<publish_date>20231010</publish_date>	NP	<publish_date>20231010</publish_date>
<doc>	NP	<doc>
S	NP	S
WITHNN	NP	WITHNN
C	NP	C
NL	NP	NL
PONDENALEX	NP	PONDENALEX
MARDTARE.	NP	MARDTARE.
HE'S	NP	HE'S
OVECLL	NP	OVECLL
WHEN	WRB	when
THE.	NP	THE.
SO	RB	so
ALEX,E	JJ	ALEX,E
TH	NN	th
S	NP	S
J	NP	J
ANDOUT	NP	ANDOUT
THE	NP	THE
CONT	NP	CONT
BY	IN	by
THE	DT	the
AIR	NN	air
I	PP	I
FROM	IN	from
GAZA.	NP	GAZA.
WE	PP	we
SEEING	VVG	see
ON	RP	on
THE	DT	the
S	NP	S
THIS	DT	this
WAR	NN	war
NOW	RB	now
IS	VBZ	be
UN?	NP	UN?
WWH	NP	WWH
TO	TO	to
ABFI	NP	ABFI
RESPONSE	NN	response
THAT	IN/that	that
PRIME	JJ	prime
MINISTER	NN	minister
NETANYAHUWITH	NP	NETANYAHUWITH
MAJORST	NP	MAJORST
T	NN	T
NEXT.	NP	NEXT.
THIS	DT	this
UP	NP	UP
HERE	RB	here
IS	VBZ	be
THE	DT	the
NORTHERN	NP	NORTHERN
RDER	NP	RDER
OF	IN	of
ISRA	NP	Isra
LEBANON,	NP	LEBANON,
MAJOR	JJ	major
QUESTIONS	NNS	question
RIGHT	RB	right
NOW	RB	now
ABOUT	IN	about
R	NP	R
HEZB	NP	HEZB
ANOTHER	DT	another
MILI	NP	Mili
G	NP	G
LIKIS	NP	LIKIS
AO	NP	AO
BY	IN	by
IRAN,	NP	IRAN,
WHETHR	NP	WHETHR
OLVED	NP	OLVED
THIS	DT	this
FIGHTD	NP	FIGHTD
OPENP	NP	OPENP
A	NP	A
SECON	NP	SECON
WE	PP	we
SAWISBY	NP	SAWISBY
ZBINTO	NP	ZBINTO
ISRAEL	NP	Israel
TO	TO	to
CARRIED	VVN	carry
OUT	IN	out
AN	DT	an
TR	NP	TR
SMALL	NP	SMALL
LAH	NN	lah
FIGHTERS.	NP	FIGHTERS.
BUT	CC	but
THE	DT	the
AJORITY	NN	AJORITY
OF	IN	of
WHAT	WDT	what
WE'RE	NP	WE'RE
SEEING	NN	seeing
ID	NN	id
GAZA	NP	Gaza
IN	IN	in
CENTRA	NN	centra
EL.	NP	EL.
ISRAEL.KED	NP	ISRAEL.KED
BY	IN	by
HAMATHIS	NP	HAMATHIS
IS	VBZ	be
THZA,Y	NP	THZA,Y
SIEDITHBUT	NP	SIEDITHBUT
THERE	RB	there
BLOCKAD	NP	BLOCKAD
WALLS	NNS	wall
AND	CC	and
IISOSE	NP	IISOSE
FENC	NP	FENC
TMAATS	NP	TMAATS
WO	MD	wo
OUT	RB	out
AND	CC	and
KILL	VV	kill
SO	RB	so
MANY	JJ	many
PEOPLE.	NP	PEOPLE.
AGAIN,	NP	AGAIN,
THE	NP	THE
ISRAELIS	NPS	Israelis
NG	NP	Ng
OUERS	NP	OUERS
AG	NP	AG
EE	NP	EE
ALONG	IN	along
THE	DT	the
P	NN	P
AS	IN	as
YOU	PP	you
D.	NP	D.
THE	DT	the
DEATH	NN	death
TOLLIN	NP	Tollin
9SRAELIR,	NP	9SRAELIR,
ST	NP	St
7ANS	NNS	7ANS
IN	IN	in
T	NN	T
ZA.	NP	ZA.
SS	NP	SS
IS	VBZ	be
REALLY,	NP	REALLY,
FIRST	NP	FIRST
OF	IN	of
WEEKISY	NP	WEEKISY
EXTRAORDINARYANENTED.	NP	EXTRAORDINARYANENTED.
IT'S	NP	IT'S
WHY	WRB	why
THEEASONS	NP	THEEASONS
WHY	WRB	why
THISIS	NN	THISIS
A	DT	a
RESPONSE	NN	response
FROM	IN	from
ISRAEL.NOW	NP	ISRAEL.NOW
INSIF	NP	INSIF
COUPLE	NN	couple
O,	NP	O,
WHATARE	NP	WHATARE
WEINELNE	NP	WEINELNE
OF	IN	of
TE	NN	te
MOST	JJS	most
DENSELYSON	NP	DENSELYSON
EARTH.	NP	EARTH.
THE	NP	THE
QU	NP	Qu
NOW	NP	NOW
IWHETHEKEEVOLVE	NP	IWHETHEKEEVOLVE
A	NP	A
GRO	NP	Gro
AIRSTRIKES.	NP	AIRSTRIKES.
OUR	PP$	our
REG	NP	Reg
TEAMS	NNS	team
OFOLD	JJ	OFOLD
US	NP	US
THAT	IN/that	that
THEHAP	NP	THEHAP
OFTA	NP	OFTA
OF	IN	of
THAT	DT	that
FOURTH.RANGE	NP	FOURTH.RANGE
AROUNZAE	NP	AROUNZAE
ISRR	NP	ISRR
EY	NP	EY
INTO	IN	into
DUTYTHIS	NP	DUTYTHIS
I	NP	I
AND	CC	and
RSTRIKES	NP	RSTRIKES
COULDBE	NP	COULDBE
SO	IN	so
DEADLY	JJ	deadly
S	NP	S
NSE.	NP	NSE.
ADS,	NP	ADS,
REFUGEE	NN	refugee
CAMPS,	NP	CAMPS,
IS,	NP	IS,
PEOPLE	NNS	people
Y	NN	Y
LIVING	VVG	live
HERE,	NP	HERE,
AROUNDILDREN.	NP	AROUNDILDREN.
IN	IN	in
JUS14	NP	JUS14
SO,	NP	SO,
CIVILIANS	NNS	civilian
WILL	MD	will
ALMOST	RB	almost
CEAISISNTINUES	NP	CEAISISNTINUES
AND	CC	and
HAMAS	NP	HAMAS
HAT,	NP	HAT,
IF	IN	if
IS	VBZ	be
NO	DT	no
ISRAELI	JJ	Israeli
WARNIN	NP	WARNIN
THAT	IN/that	that
E	NN	E
DOZENS	NNS	dozen
OF	IN	of
HOES	NNS	hoe
WE	PP	we
KNOW	VVP	know
AND	CC	and
THEN	RB	then
BRA	NN	bra
REALHIMESSAGE.	NP	REALHIMESSAGE.
&gt;&gt;SR	NP	&gt;&gt;SR
WARNINGRE	NP	WARNINGRE
THE	NP	THE
ATTACKS.	NP	ATTACKS.
THESEAESSENTIALL	NP	THESEAESSENTIALL
TAKING	VVG	take
PLACES	NNS	place
GAZA.FE	NP	GAZA.FE
THEY	PP	they
DO	VVP	do
TWO	CD	two
TH	NN	th
A	DT	a
ROOF	NN	roof
KNOCK,	NP	KNOCK,
THAT	IN/that	that
B.WILL	NP	B.WILL
WARN	VV	warn
THE	DT	the
THHAVENUMBERS	NP	THHAVENUMBERS
OFHE	NP	OFHE
RESID.	NP	RESID.
CEITH	NP	CEITH
SO	IN	so
THEMTHS	NPS	THEMTHS
A	DT	a
MEE	NN	mee
IN	IN	in
ARABIC	NP	Arabic
SAW	VVD	see
ETE	NP	ETE
HOUSOUED	NP	HOUSOUED
TO	TO	to
EVACUA	NP	EVACUA
NOW.	NP	NOW.
ISELS	NP	ISELS
SANGSE	NP	SANGSE
DOING,	NP	DOING,
HAMAS	NP	HAMAS
I	PP	I
AI	VVP	ai
THAOSE	NP	THAOSE
MEAREN'T	NP	MEAREN'T
GET	VV	get
T	NN	T
THA	NP	THA
ISRAEL	NP	Israel
IS.	NP	IS.
&gt;&gt;	NN	&gt;&gt;
THERE	RB	there
WAS	VBD	be
ALSO	RB	also
AN	DT	an
ATTACK,	NP	ATTACK,
ANN	NP	Ann
SQIN	NP	SQIN
THE	NP	THE
LDA	NP	LDA
SO.	NP	SO.
TELL	VVP	tell
US	NP	US
ABOU	NP	ABOU
WE	PP	we
KNOW	VVP	know
OU&gt;&gt;	NP	OU&gt;&gt;
THE	NP	THE
AND	CC	and
WE'REING	NP	WE'REING
AT	IN	at
HERE	RB	here
REFUGEE	NN	refugee
THE	DT	the
NORTHWESTN	NP	NORTHWESTN
PART	NN	part
OF	IN	of
TH	NN	th
S.	NP	S.
ARE	VBP	be
WE	PP	we
HAVE	VHP	have
SOME	DT	some
REMARKAEBE	NP	REMARKAEBE
IS	VBZ	be
N	NP	N
AT	IN	at
CAMP.	NP	CAMP.
YOU	PP	you
CAN	MD	can
NOW	RB	now
SEAT	VV	seat
NOW	RB	now
JUST	RB	just
,	,	,
REFUGEE	NN	refugee
CAMP.	NP	CAMP.
THIS	DT	this
IS	VBZ	be
W	NP	W
THAT	DT	that
ITHE	NN	ITHE
BEFORE	IN	before
OF	IN	of
A	DT	a
SATELLITE	JJ	satellite
IMAGE,	NP	IMAGE,
NOW	NP	NOW
OBVIOUSLYTY	NP	OBVIOUSLYTY
DESTROYED	VVD	destroy
THISE	NP	THISE
THIRD	JJ	third
MOSQUE,	NP	MOSQUE,
M	NP	M
SAME	JJ	same
FUGEWHY	NP	FUGEWHY
IS	VBZ	be
IG	NP	IG
MOSQUES?	NP	MOSQUES?
PAST	IN	past
CONFCTT	NP	CONFCTT
USING	VVG	use
CIVILIAN	JJ	civilian
FRDIS	NP	FRDIS
N	NP	N
UES,	NP	UES,
THEIR	PP$	their
HOLIEST	JJS	holy
PLA	NP	PLA
R	NP	R
FORCES,	NP	FORCES,
BUT	CC	but
MAINLY	RB	mainly
THEIR	PP$	their
WEAPONS.	NP	WEAPONS.
OF	IN	of
COURSE,	NP	COURSE,
WE	PP	we
HA	NP	ha
SOU	NN	sou
MISSILES	NNS	missile
BG	NP	BG
</doc>	NN	</doc>
