<video_id>ndqjS_QYtU0</video_id>	JJ	<video_id>ndqjS_QYtU0</video_id>
<video_title>Inside	NN	<video_title>Inside
the	DT	the
network	NN	network
of	IN	of
Hamas	JJ	Hamas
tunnels	NNS	tunnel
under	IN	under
Gaza</video_title>	NP	Gaza</video_title>
<thumbnail_path>data/en_CNN\Inside	NN	<thumbnail_path>data/en_CNN\Inside
the	DT	the
network	NN	network
of	IN	of
Hamas	JJ	Hamas
tunnels	NNS	tunnel
under	IN	under
Gaza.jpg</thumbnail_path>	NP	Gaza.jpg</thumbnail_path>
<publish_date>20231026</publish_date>	NN	<publish_date>20231026</publish_date>
<doc>	NN	<doc>
HIS	PP$	his
EARLIER	JJR	early
TODAY,L'S	NP	TODAY,L'S
PRIME	JJ	prime
MINISTER	NN	minister
BJAMIN	NN	BJAMIN
NE	RB	ne
TROOPGAZA.	NP	TROOPGAZA.
QUOTW,	NP	QUOTW,
I	NP	I
WIL	NP	wil
NS	NP	NS
TAKING	VVG	take
INTO	IN	into
T,	NP	T,
I	PP	I
LIVE	VVP	live
OF	IN	of
OUR	PP$	our
SOLDIERS.WHETHEOK	NP	SOLDIERS.WHETHEOK
O	NP	O
THOSE	DT	those
CONSIDERATIONS	NNS	consideration
IS	VBZ	be
NL	NP	NL
TUNNL	NP	TUNNL
MOSON.	NP	MOSON.
T	NN	T
BLE	NN	BLE
DANGER	NN	danger
AWAITING	VVG	await
ISRAELI	JJ	Israeli
TROOPS	NNS	troop
ELILES	NP	ELILES
OF	IN	of
THEM,	NP	THEM,
HIDING	VVG	hide
THE	DT	the
WD	NP	WD
TERRORS	NNS	terror
PROPAGAN	NP	PROPAGAN
DEFEFOE	NP	DEFEFOE
SHOWREINFORCED	NP	SHOWREINFORCED
SUBTEN	NP	SUBTEN
GROUND.FSHITZ,	NP	GROUND.FSHITZ,
SAW	VVD	see
D	NP	D
BEFORE	IN	before
S	NP	S
WE	PP	we
&gt;&gt;	NP	&gt;&gt;
Reporr:	NP	Reporr:
PALESTINIAN	NP	Palestinian
ISLAMIC	NP	Islamic
HAD	VHD	have
HAVE	VH	have
LD	NP	LD
CONCYEARS,	NP	CONCYEARS,
CNN	NP	CNN
CAPTU	NP	CAPTU
N	NP	N
SHOWN	VVN	show
THEM	PP	them
BH	NP	BH
THE	DT	the
GROUPS	NNS	group
THSEING	VVG	THSEING
OFF	RP	off
THEIR	PP$	their
UNDER	IN	under
THEY	PP	they
SNAKENEATF	NP	SNAKENEATF
APONS,	NP	APONS,
ESTIMATEO	NP	ESTIMATEO
NEIGHBORHOODS.	NP	NEIGHBORHOODS.
AND	CC	and
THEY'VCOO	NP	THEY'VCOO
AS	IN	as
THE	DT	the
GAZA.DES	NP	GAZA.DES
PROGRESSION	NN	progression
INION,	NP	INION,
INER	NP	INER
TO	TO	to
TROO	NP	TROO
THE	NP	THE
EVOF	NP	EVOF
A	NP	A
GROUNCUN	NP	GROUNCUN
GAZA.LI	NP	GAZA.LI
A	NP	A
E	NP	E
NCING	NP	NCING
TRPSEV	NP	TRPSEV
U	NP	U
AND	CC	and
THE	DT	the
DANGER	NN	danger
DOWN	IN	down
T	NN	T
JUSTTHE	NP	JUSTTHE
OO	NP	Oo
ISRAELI	NP	Israeli
CIVIS	NP	CIVIS
TOO.	NP	TOO.
STORED	VVD	store
BED	NN	bed
RWE	NP	RWE
FIRED	VVD	fire
TOWARD	IN	toward
AVIV	NP	Aviv
AND	CC	and
OTHER	JJ	other
CITIES	NNS	city
FROM	IN	from
HIDDEN	JJ	hidden
GUN	NN	gun
PCODIRECTLY	NP	PCODIRECTLY
TO	TO	to
THTUEL	NP	THTUEL
IOISRAEL	NP	IOISRAEL
EXPECTONELS.	NP	EXPECTONELS.
TO	TO	to
STRIKEK	NP	STRIKEK
ABSENTHA	NP	ABSENTHA
SO-CALLED	JJ	so-called
G	NP	G
D	NP	D
ENDANGER	VV	endanger
ALIKE.	NP	ALIKE.
M	NP	M
RET	VVP	ret
U	NP	U
EL	NN	el
MEMEE	NP	MEMEE
ATE	VVD	eat
DEEP	RB	deep
DOWN	RB	down
AND	CC	and
TAKE	VV	take
SOME	DT	some
OELSION,	NP	OELSION,
THE	NP	THE
IDF	NP	IDF
WEN	NN	wen
AND	CC	and
TO	TO	to
GET	VV	get
RID	JJ	rid
OF	IN	of
TUNNELS.	NP	TUNNELS.
Y	NP	Y
SHOWS	VVZ	show
TH	NN	th
RHENI	NP	RHENI
THEY'RE	NP	THEY'RE
NOT	RB	not
GOING	VVG	go
TO	TO	to
BE	VB	be
ABLE	JJ	able
ERADICATALRE	NP	ERADICATALRE
THTRNG	NP	THTRNG
TO	TO	to
FACE	VV	face
INAND	NP	INAND
THCOURSE,	NP	THCOURSE,
HEAVIN	NP	Heavin
SEITANT	NP	SEITANT
N	NP	N
THEY	PP	they
TNKY	NP	TNKY
CLEARED	VVD	clear
A	DT	a
HOUSE	NP	HOUSE
OR	CC	or
ERKS.,	NP	ERKS.,
&gt;&gt;O	NP	&gt;&gt;O
GERSPECTIVE	NP	GERSPECTIVE
ES	NP	ES
THELS	NP	THELS
MIGHT	MD	might
PRE	NP	Pre
WITH	IN	with
RED	JJ	red
ONEL	NP	ONEL
MON	NP	MON
SURE,	NP	SURE,
RMER	NP	RMER
TOP	JJ	top
AID	NN	aid
TNE.	NP	TNE.
SO,	NP	SO,
I	NP	I
AN'S	NP	AN'S
T	NN	T
OUT	RB	out
AND	CC	and
ALSO	RB	also
HAMAS	JJ	HAMAS
PROPAGDA.	NP	PROPAGDA.
CHALLENGES	NNS	challenge
OF	IN	of
DEIN	NP	DEIN
A	DT	a
TWW	NNS	TWW
DO	VVP	do
DESOYM?HOW	NN	DESOYM?HOW
DO	VVP	do
I?	JJ	I?
&gt;&gt;EL	NN	&gt;&gt;EL
PREFERABLY	RB	preferably
YOU	PP	you
DON'T	NP	DON'T
FIGH	NP	FIGH
WN	NP	WN
IWO	NP	Iwo
MA,	NP	MA,
INSTANCE,	NP	INSTANCE,
E	NP	E
JAPANESE	JJ	JAPANESE
HAD	VHD	have
TUNNE.	NP	TUNNE.
THE	DT	the
MANE	NN	mane
FIND	VV	find
THE	DT	the
ENTRCE	NP	ENTRCE
HETHER	NP	HETHER
WITEXDOZERS	NP	WITEXDOZERS
OR	CC	or
FLAMWERS.	NP	FLAMWERS.
AND	CC	and
THEY	PP	they
WOULD	MD	would
ENTE	NP	Ente
HIS	PP$	his
ISBLBECAUSE	NN	ISBLBECAUSE
INSIDE	IN	inside
THOSE	DT	those
TUF	NP	TUF
ESHAHA	NP	ESHAHA
TAKEN.	NP	TAKEN.
AND	CC	and
OF	IN	of
COURSE	NN	course
YOU	PP	you
WANT	VVP	want
TO	TO	to
FR.FIU	NP	FR.FIU
ANE	NNS	ANE
DEFEND	VVP	defend
SOI	NP	SOI
DEFENSE	NN	defense
FORCESEAINLO	NP	FORCESEAINLO
FIGHT	NN	fight
INSIDE	IN	inside
N	NP	N
ABOUT	IN	about
THE	DT	the
TUNNEL	NN	tunnel
EMELY	NP	Emely
ULT.	NP	ULT.
&gt;&gt;	NP	&gt;&gt;
YES,	NP	YES,
YOGHT	NP	YOGHT
BE	VB	be
ABLE	JJ	able
TO	TO	to
PERSIS	NP	Persis
FIND	VV	find
THE	DT	the
ENTNC	NP	ENTNC
E	NN	E
THEY	PP	they
SNAKE	VVP	snake
AROUND	RB	around
,	,	,
HO	NP	Ho
TO	TO	to
TFROMOVER	NP	TFROMOVER
THE	NP	THE
ISRAELIS,	NP	ISRAELIS,
AS	IN	as
THEY	PP	they
ADVANCE	VVP	advance
D	NP	D
OFFENSIVE	NN	offensive
ARE	VBP	be
IN	IN	in
LEAVE	NN	leave
TROOPS	NNS	troop
IN	IN	in
THE	DT	the
REAR	JJ	rear
T	NN	T
THEI	NP	THEI
THEY	PP	they
CAN'T	NP	CAN'T
ASSUME	VV	assume
THAT	IN/that	that
ONCE	RB	once
MILITANTS	NNS	militant
CAN	MD	can
ME	PP	me
UP	RP	up
FROM	IN	from
THE	DT	the
OU.	NP	OU.
&gt;&gt;	NN	&gt;&gt;
ANDN	NP	ANDN
E	NP	E
URN	NN	urn
ENVIRONMENIK,	NP	ENVIRONMENIK,
WITHBRIS	NP	WITHBRIS
AROUND,	NP	AROUND,
I	NP	I
KNY	NP	KNY
HAVE	VHP	have
URBA?L,	NP	URBA?L,
IT'S	NP	IT'S
MISNOMERNKSIN	NP	MISNOMERNKSIN
URBAMBS	NP	URBAMBS
JUST	RB	just
IY	NP	IY
COMBAT.	NP	COMBAT.
THE	DT	the
BEST	JJS	good
F	NN	F
T	NN	T
URBAN	JJ	urban
IS	VBZ	be
ING	NP	Ing
VEHICLES.T	NP	VEHICLES.T
THEY	PP	they
NEED	VVP	need
TO	TO	to
B	NP	B
ITS	PP$	its
.IN	NN	.IN
THE	DT	the
URBAFORCE	NP	URBAFORCE
ASSETS.E	NP	ASSETS.E
EXPERIS	NP	EXPERIS
OR	CC	or
FALIAN	NP	FALIAN
POPULATIONH	NP	POPULATIONH
CF	NP	CF
PLACES?	NP	PLACES?
FORCES	VVZ	force
A	DT	a
IRAS	NP	IRAS
BEFORE	IN	before
TY	NP	TY
IN.GAVE	NP	IN.GAVE
THAT	WDT	that
WAS	VBD	be
AY	RB	ay
CLEAYOWI	NP	CLEAYOWI
MOSUIL,	NP	MOSUIL,
FEWER	JJR	few
TN	NP	TN
AR	NP	Ar
SUALTIES	NP	SUALTIES
IN	IN	in
THAT	DT	that
TAN	JJ	tan
AQ	NP	AQ
WENT	VVD	go
ABOURI	NP	ABOURI
MOSUL	NP	Mosul
REDUCED	VVD	reduce
THOSE	DT	those
USING	VVG	use
SPECIA	NP	SPECIA
AND	CC	and
TARG	NP	TARG
STRIKES.	NP	STRIKES.
IF	IN	if
YOU	PP	you
GO	VVP	go
IN	IN	in
WA	NP	Wa
BIG,VYGROUND	NP	BIG,VYGROUND
IN	IN	in
DESTRUCTION	NN	destruction
IN	IN	in
THE	DT	the
PATH	NN	path
OF	IN	of
THE	DT	the
NC	NP	NC
CIVILIANS	NNS	civilian
ARE	VBP	be
IN	IN	in
THOSE	DT	those
BUILDING	VVG	build
ATEF	NP	Atef
THEM	PP	them
A	NP	A
G	NP	G
DIE.	NP	DIE.
&gt;&gt;	NP	&gt;&gt;
AND	CC	and
S	NP	S
TT	NP	TT
TH	NN	th
OF	IN	of
MORE	JJR	more
LIMIT	NN	limit
INCURSION	NN	incursion
WIT	NN	wit
ECL	NP	ECL
FORCIS	NP	FORCIS
THAT	IN/that	that
SOMETHING	NN	something
REON	NP	Reon
&gt;&gt;	NP	&gt;&gt;
THERE'S	NP	THERE'S
A	NP	A
ME	PP	me
THREE	CD	three
THE	DT	the
POP?	NP	POP?
STAR	NN	star
GALN	NP	GALN
ISRAELIG	NP	ISRAELIG
NOWO'ECOMMENL	NP	NOWO'ECOMMENL
DEFENSE	NN	defense
FORCTO.	NP	FORCTO.
AKES	NP	Akes
LONGER.S	NP	LONGER.S
CA	MD	ca
THE	DT	the
ISRAELI	JJ	Israeli
GOVERNME	NP	GOVERNME
TKE.	NP	TKE.
HOE	NN	hoe
WORLD	NN	world
COMMUNITY	NN	community
IN	IN	in
WITH	IN	with
GROUND	NN	ground
FORCES?	NN	FORCES?
CAN	MD	can
EYRS	JJ	EYRS
</doc>	NN	</doc>
