<doc>	NP	<doc>
MAX	NP	Max
FOSTER	JJ	foster
IN	IN	in
LONDON.	NP	LONDON.
&gt;&gt;	NN	&gt;&gt;
AND	CC	and
THIS	DT	this
ISG	NP	ISG
PALESTINIAN	JJ	Palestinian
SIDE	NN	side
OF	IN	of
THE	DT	the
RAFAH	NP	RAFAH
CROSSING	VVG	cross
THIS	DT	this
ISCCORDINGO	NP	ISCCORDINGO
RALEE	NP	RALEE
FORCRE	NP	FORCRE
THE	NP	THE
AND	NP	AND
WITH	IN	with
ARTILLY	NP	ARTILLY
TA	NP	TA
OF	IN	of
COURSHAVE	NP	COURSHAVE
SOUGHT	VVD	seek
MIPOED	JJ	MIPOED
EVEN	JJ	even
THOUGHFFA.	NP	THOUGHFFA.
THIS	DT	this
CO	NP	Co
S	NP	S
IS	VBZ	be
FARM	NN	farm
RACESSARY	NP	RACESSARY
IREMENND	NP	IREMENND
OBVIOUSL	NP	OBVIOUSL
REGARDLESER	NP	REGARDLESER
ME.	NP	ME.
HE	PP	he
IINE	NP	IINE
SIGNIFICANT	JJ	significant
MOVEMENT	NN	movement
IN	IN	in
RAFFA.	NP	RAFFA.
WHYOU	NP	WHYOU
UNDERSTAND	VVP	understand
IT	PP	it
RIGHT	JJ	right
NOW.	NP	NOW.
ESN,	NP	ESN,
WE	PP	we
EI	NP	EI
EXPLOSIONS	NNS	explosion
GHGH	NP	GHGH
R	NP	R
APPEARS	VVZ	appear
HAWE	NP	Hawe
INCLUDING	VVG	include
IN	IN	in
RAFFAEAD,	NP	RAFFAEAD,
I	NP	I
ISRAEL	NP	Israel
ANALYSTS,	NP	ANALYSTS,
BARACK	NP	BARACK
RAVID	NP	Ravid
THAT	IN/that	that
THRE	NP	THRE
MOVING	NN	moving
,	,	,
RAA	NP	RAA
WITHRON	NP	WITHRON
ORDETO	NP	ORDETO
OVER	IN	over
THATNG	NP	THATNG
WHIC	NP	WHIC
ONBORDER	NP	ONBORDER
KNOWN	VVN	know
HE	PP	he
CRITICALLIAOU	NP	CRITICALLIAOU
VERYEGICENYPT	NP	VERYEGICENYPT
AND	CC	and
GAZA.	NP	GAZA.
ERRYIE	NP	ERRYIE
AS	NP	AS
SMUGGLING	NN	smuggling
OPERATIONS	NP	OPERATIONS
ALSO	RB	also
TAKE	VV	take
PLACE	NN	place
R	NN	R
EXACTLY	RB	exactly
THE	DT	the
HIAT	NP	HIAT
THI	NP	Thi
IN	IN	in
PALES	NNS	pale
TER	NN	TER
THE	DT	the
ISRAEERED	JJ	ISRAEERED
TENS	NNS	ten
O	NP	O
RAFFA,	NP	RAFFA,
AUTVIN	NP	AUTVIN
ND	NN	ND
OF	IN	of
HAT	NN	hat
AREA.	NP	AREA.
AND	CC	and
NOW	NP	NOW
LEATER,	NP	LEATER,
IT	PP	it
NOT	RB	not
ONLY	RB	only
IS	VBZ	be
THE	DT	the
RY	NN	RY
CARRYING	VVG	carry
STRIKES	NNS	strike
IN	IN	in
EASTERN	JJ	eastern
RAFFA,	NP	RAFFA,
BUT	CC	but
ALSO	RB	also
APPARENTLY	RB	apparently
MOVING	VVG	move
IN	IN	in
S	NP	S
TA	NP	TA
T	NN	T
A	DT	a
MAJOR	JJ	major
FFA	NP	FFA
ST	NP	St
FOR,	NP	FOR,
THAT	IN/that	that
THAT	DT	that
ATTAIN	VV	attain
LEVEL.	NP	LEVEL.
ALL	DT	all
RITS	NP	RITS
CLK	NP	CLK
A	NP	A
SATHE	NP	Sathe
VE	NP	VE
MONTHS,	NP	MONTHS,
E	NP	E
S	NP	S
HAS	VHZ	have
WAL	NP	Wal
AGAINST	IN	against
ATTACKING	VVG	attack
F	NN	F
CIVILIANS	NNS	civilian
CASUALTIES.	NP	CASUALTIES.
FLETS	NP	FLETS
TODAY	NN	today
BEING	VBG	be
DROPPED	VVN	drop
I	NP	I
EASTERFF	NP	EASTERFF
CIVILIANWHIC	NP	CIVILIANWHIC
CWHO	NP	CWHO
IS	VBZ	be
SAID	VVN	say
THE	DT	the
THE	NP	THE
GROD	NP	GROD
TION	NN	tion
EFFORTS	NNS	effort
FOR	IN	for
LIS	NP	Lis
QU	NP	Qu
OF	IN	of
GH	NP	GH
IT	PP	it
WAS	VBD	be
ALSO	RB	also
CAUSING	VVG	cause
PAUT	NP	PAUT
ARE	VBP	be
BEING	VBG	be
TOLD	VVN	tell
TO	TO	to
EVACUATE	VV	evacuate
AND	CC	and
GO	VV	go
OR	CC	or
IF	IN	if
THEY	PP	they
G	NP	G
O	NP	O
GO	VV	go
ALL	PDT	all
THE	DT	the
WAT	NN	wat
GAZA.	NP	GAZA.
NORTH	NN	north
OF	IN	of
ULNA	NN	ulna
WASHY	JJ	washy
A'	JJ	all
SET	NN	set
UP	IN	up
A	DT	a
HITARIAN	NP	HITARIAN
A	NP	A
HUMANITARI	NP	HUMANITARI
ZCALL	NP	ZCALL
AN	DT	an
EUNICE,	NP	EUNICE,
ERGHT	NP	ERGHT
IN	IN	in
FOOD,	NP	FOOD,
MEDICINE,	NP	MEDICINE,
BUT	CC	but
HUMANITARI'	NP	HUMANITARI'
ODATE	NP	ODATE
THE	DT	the
NUMBER	NN	number
OF	IN	of
RTICULARLY	NP	RTICULARLY
IF	IN	if
OF	IN	of
PANIC	NN	panic
SPHOUT	NP	SPHOUT
E	NP	E
CITY	NN	city
IN	IN	in
TERME	NP	Terme
D	NP	D
VEOD	NP	VEOD
YOU	PP	you
WILL	MD	will
SEE	VV	see
AN	DT	an
EVEN	JJ	even
LARGEF	NP	LARGEF
PEOP	NP	PEOP
COTHE	NP	COTHE
THE	DT	the
FACT	NN	fact
THAT	IN/that	that
THIS	DT	this
EVENING	NN	evening
WESEMAGES	NP	WESEMAGES
IT,	NP	IT,
SAC	NN	sac
AS	IN	as
THEY	PP	they
HAV	NP	HAV
BEING,	NP	BEING,
BUT	CC	but
OF	IN	of
THAT	DT	that
ISRAEL	NP	Israel
HELP	NN	help
C	NP	C
W	NP	W
IS	VBZ	be
NOT	RB	not
E	NP	E
ITSN'TILL	NP	ITSN'TILL
SAYING	VVG	say
THAT	IN/that	that
DEMANDSENDING	NP	DEMANDSENDING
A	NP	A
DELEGATION,	NP	DELEGATION,
T	NN	T
GROUO	NP	GROUO
ENSIDES.&gt;&gt;	NP	ENSIDES.&gt;&gt;
AND	CC	and
THEN	RB	then
WHENHE	NP	WHENHE
L	NP	L
RIGHT.	NP	RIGHT.
THANK	VV	thank
YOU	PP	you
VERYUCH.	NP	VERYUCH.
A	NP	A
JEREMIE.	NP	JEREMIE.
AWA	NP	AWA
GENERALAMNERAL	NP	GENERALAMNERAL
MARX,	NP	MARX,
EL	NN	el
OF	IN	of
ANOPERN	NP	ANOPERN
WELL,	NP	WELL,
FIRST	NP	FIRST
ARAEL,	NP	ARAEL,
HETHAT	NP	HETHAT
HERE	RB	here
WAS	VBD	be
CER	NP	CER
ARGET	NP	ARGET
FOR	IN	for
INEVITABILITY	NN	inevitability
TO	TO	to
THIS	DT	this
ION.	NP	ION.
OBJECTIVE	NN	objective
CLEARLYFOR	NP	CLEARLYFOR
ISRAEL,	NP	ISRAEL,
FOR	IN	for
THFORCES	NPS	THFORCES
TO	TO	to
HE	PP	he
MISSION,	NP	MISSION,
TO	TO	to
GO	VV	go
THINGS,	NP	THINGS,
UCREHAS	NP	UCREHAS
AND	CC	and
HAMAS	NP	HAMAS
FIGHTER	NN	fighter
W	NP	W
BEAR	NN	bear
IN	IN	in
MIND	NN	mind
OVER	IN	over
THIS.	NP	THIS.
ATAY,	NP	ATAY,
PERIOD,	NP	PERIOD,
INTERREGNUM	NN	interregnum
OF	IN	of
A	DT	a
COUPLE	NN	couple
OF	IN	of
WEEKS	NNS	week
EL	NN	el
HAS	VHZ	have
BEEN	VBN	be
G	NP	G
GNIFICANIN	NP	GNIFICANIN
THUCECONRMS	NP	THUCECONRMS
OF	IN	of
AFTER	IN	after
AND	CC	and
WHERE	WRB	where
ARE	VBP	be
THE	DT	the
WANT	VVP	want
RYOISOLATE	NP	RYOISOLATE
THE	NP	THE
G'T	NP	G'T
Y'ENSS	NP	Y'ENSS
AND	CC	and
COROLEARLY,	NP	COROLEARLY,
THE	NP	THE
IT	PP	it
INTO	IN	into
EGYPT,	NP	EGYPT,
T	NN	T
TO	TO	to
ALLOWT	NP	ALLOWT
HE	PP	he
EL	NN	el
D	NP	D
ABOU	NP	ABOU
PLAT'S	NP	PLAT'S
WHAT'IN	NP	WHAT'IN
MOSTFIGH	NP	MOSTFIGH
LLD	NP	LLD
TO	TO	to
DO	VV	do
SE	FW	se
PREPARATION,	NP	PREPARATION,
AS	NP	AS
LL	NP	LL
MAN	NN	man
E	NN	E
FROM	IN	from
THE	DT	the
KILL	NN	kill
ZONE.	NP	ZONE.
&gt;&gt;	NP	&gt;&gt;
SO	IN	so
D	NP	D
OF	IN	of
MOST	JJS	most
IMPORTANT	JJ	important
ALLY	NN	ally
AND	CC	and
CERTAINLY	RB	certainly
IN	IN	in
A	DT	a
WORLD	NN	world
WHERE	WRB	where
ISOLATS	NP	ISOLATS
MOSTOR	NP	MOSTOR
HAS	VHZ	have
Y	NN	Y
SAT	VVD	sit
DON'SSAN	NP	DON'SSAN
AT	IN	at
IS	VBZ	be
UBV,ORGALY	NP	UBV,ORGALY
THA	NP	THA
IATMA	NP	IATMA
NEGOINAH	NP	NEGOINAH
SPITE	NN	spite
VEREA	NP	VEREA
NITION	NP	NITION
YEAWANT	NP	YEAWANT
TO	TO	to
BE	VB	be
KROOS,	NP	KROOS,
A	DT	a
MATTER	NN	matter
KEREALIZES	VVZ	KEREALIZES
TT	NP	TT
RAFFA	NP	Raffa
IS	VBZ	be
CLEARED.	NP	CLEARED.
D	NP	D
EE	NP	EE
THAT	IN/that	that
THA	NP	THA
TO	TO	to
TAKE	VV	take
PLACE.	NP	PLACE.
LET'S	NP	LET'S
BE	VB	be
FRANK,	NP	FRANK,
DEOGGOING	NP	DEOGGOING
TO	TO	to
CONTINUE	VV	continue
GROW.	NP	GROW.
YO'ABLE	JJ	YO'ABLE
T	NN	T
AS	IN	as
IT	PP	it
EXIS	NN	EXIS
RIGHT	NN	right
N	NP	N
HAMAS	NP	HAMAS
WILL	MD	will
S,	NP	S,
WHAT	WDT	what
WE	PP	we
WOULDXPECT	VVZ	WOULDXPECT
TO	TO	to
YOU	PP	you
WANT	VVP	want
TSE	NP	Tse
ESSENTIALLY	RB	essentially
G	NP	G
PRESIDEN,	NP	PRESIDEN,
BUT	CC	but
I	NP	I
HAVEO	NP	HAVEO
MPLETE	NP	MPLETE
THIS	DT	this
JOB	NN	job
AND	CC	and
S	NP	S
SAID,	NP	SAID,
HE'S	NP	HE'S
G	NP	G
CHICKEN.'S	NP	CHICKEN.'S
GOING	VVG	go
TR	NP	TR
OPROVIDING	NP	OPROVIDING
THE	DT	the
</doc>	NN	</doc>
