<video_id>dPKox2abTik</video_id>	NP	<video_id>dPKox2abTik</video_id>
<video_title>New	NP	<video_title>New
IDF	NP	IDF
video	NN	video
appears	VVZ	appear
to	TO	to
show	VV	show
Hamas	NNS	Hamas
attempting	VVG	attempt
to	TO	to
enter	VV	enter
Israel	NP	Israel
by	IN	by
sea</video_title>	NP	sea</video_title>
<thumbnail_path>data/en_CNN\New	NP	<thumbnail_path>data/en_CNN\New
IDF	NP	IDF
video	NN	video
appears	VVZ	appear
to	TO	to
show	VV	show
Hamas	NNS	Hamas
attempting	VVG	attempt
to	TO	to
enter	VV	enter
Israel	NP	Israel
by	IN	by
sea.jpg</thumbnail_path>	JJ	sea.jpg</thumbnail_path>
<publish_date>20231026</publish_date>	NN	<publish_date>20231026</publish_date>
<doc>	NN	<doc>
N	NP	N
OF	IN	of
"OUROW	NP	"OUROW
ATTACKAGRAAV	NP	ATTACKAGRAAV
GAZIN	NP	GAZIN
I.	NP	I.
NETANYAHU	NP	NETANYAHU
SENDHAMNI	NP	SENDHAMNI
TO	TO	to
COME.	NP	COME.
WE	PP	we
GO	VVP	go
INTO	IN	into
N	NP	N
THONGH	NP	THONGH
WT	NP	WT
TH	NN	th
SAYING	VVG	say
WHE	NP	WHE
COULD&gt;&gt;	NP	COULD&gt;&gt;
Reporter:	NP	Reporter:
NEU	NP	Neu
TO	TO	to
DETOHETAS	NP	DETOHETAS
&gt;&gt;	NP	&gt;&gt;
WELL,	NP	WELL,
I	NP	I
HAVDITE	NP	HAVDITE
HIM	PP	him
BUI	NP	Bui
D	NP	D
NOT	RB	not
DEMAND	VV	demand
IT.O	NP	IT.O
THESE	DT	these
FOLS	NP	FOLS
&gt;&gt;AR0	NN	&gt;&gt;AR0
OF	IN	of
THOSE	DT	those
AG	NP	AG
THERE.	NP	THERE.
RA	NP	RA
IT	PP	it
THWARERCKEF	NP	THWARERCKEF
NATIONAL	NP	NATIONAL
SECURITY	NN	security
HAS	VHZ	have
THISEW	NP	THISEW
VIT.orter:	NP	VIT.orter:
ON	NP	ON
ESDAY,	NP	ESDAY,
ATTTO	NP	ATTTO
ENTEM	NP	ENTEM
GAZAY	NP	GAZAY
SEA,	NP	SEA,
TH,	NP	TH,
GUNNN	NP	GUNNN
ONTHE	NP	ONTHE
THETHE	NP	THETHE
T	NN	T
ISRAE	NP	ISRAE
HAS	VHZ	have
ATTEMPTETO	NP	ATTEMPTETO
ENTER	VV	enter
ISRAEL	NP	Israel
BYA	NP	BYA
ARED	NP	ARED
RAID,	NP	RAID,
IFO	NP	IFO
TTED	NP	TTED
BY	IN	by
THE	DT	the
ISRAELI	NP	Israeli
CAPABILITIESN	NP	CAPABILITIESN
EVASTATING	NP	EVASTATING
AITR	NP	AITR
ISRAEL	NP	Israel
IZED	NP	IZED
PARAGLIDERS.VEILLANT	NP	PARAGLIDERS.VEILLANT
FIED	NP	FIED
ISRL	NP	ISRL
ON	NP	ON
MOLES	NNS	mole
AND	CC	and
IN	IN	in
SUVs.	NP	SUVs.
MAS	NNS	ma
DIVEORM	NN	DIVEORM
A	DT	a
&gt;&gt;	NN	&gt;&gt;
THIS	DT	this
FORC	NN	FORC
THAT	WDT	that
IS	VBZ	be
A	DT	a
COMBINATION	NN	combination
OF	IN	of
TERROAS	NP	TERROAS
HASATTRI	NP	HASATTRI
CONVEL	NP	CONVEL
MILITARY.	NP	MILITARY.
AND	CC	and
WHAT'S	NP	WHAT'S
PARTICULARLTEREST	NP	PARTICULARLTEREST
TY	NP	TY
LAND,	NP	LAND,
AND	CC	and
&gt;&gt;	NP	&gt;&gt;
Reporter:	NP	Reporter:
HAMAS	NP	HAMAS
HAS	VHZ	have
HONED	VVN	hone
ESE	JJ	ESE
MA	NN	ma
ONOCK-UP	NN	ONOCK-UP
AN	DT	an
A	NP	A
PSIE	NP	PSIE
THEYBER	NP	THEYBER
7tTO	NP	7tTO
DEADLY	JJ	deadly
.	SENT	.
OFFENSIVE	JJ	offensive
INSID,	NP	INSID,
E	NP	E
CONCERN	NN	concern
AMO	NP	Amo
OFFICIS	NP	OFFICIS
S	NP	S
WI	NP	WI
FORCESDAARE.	NP	FORCESDAARE.
AGAINST	IN	against
ISRAELI	NP	Israeli
GAZA	NP	Gaza
ID	NN	id
URHAMAS	NN	URHAMAS
HAS	VHZ	have
CONSTE	JJ	CONSTE
COMPLEX	JJ	complex
NETWORK	NN	network
OF	IN	of
TUNNEGGED	NP	TUNNEGGED
WI.	NP	WI.
&gt;&gt;	NP	&gt;&gt;
IT'	NP	IT'
CLEAR	JJ	clear
THA	NP	THA
CAN	MD	can
MOUNT	VV	mount
A	DT	a
COORDINATERCATSRL,TB	NP	COORDINATERCATSRL,TB
DEFENSIVE	NN	defensive
OPERATION,	NP	OPERATION,
A	NP	A
COMBINEDEN	NP	COMBINEDEN
INK	NN	ink
ND	NN	ND
THAT	IN/that	that
THE	DT	the
MARINETA	NP	MARINETA
FIALE	NP	FIALE
COMMN	NP	COMMN
TOERALL	NP	TOERALL
S.	NP	S.
AH	UH	ah
IN	IN	in
THS	JJ	ths
BLOODYR	NP	BLOODYR
U.S.	NP	U.S.
FORCE	VV	force
ENORMOUS	JJ	enormous
LOSSES	NNS	loss
ONHE	NP	ONHE
PREPAR	NP	PREPAR
USED	VVD	use
SO	RB	so
MUCH	JJ	much
DAMAGE.	NP	DAMAGE.
OURSE,	NP	OURSE,
HAMAS	NP	HAMAS
HAS	VHZ	have
H	NP	H
MANY	JJ	many
RE&gt;&gt;	NP	RE&gt;&gt;
THANKOUMUCH	NP	THANKOUMUCH
&gt;&gt;&gt;	NP	&gt;&gt;&gt;
AND	CC	and
NOE'S	NP	NOE'S
VELY	NP	VELY
ON	NP	ON
HAMAS,	NP	HAMAS,
AND	CC	and
THE	DT	the
"GETTING	NN	"GETTING
TO	TO	to
HAMAS."	NP	HAMAS."
YOU	PP	you
SH	NP	SH
WR	NP	WR
VIEWERS	NNS	viewer
ONE	CD	one
DERS	NN	DERS
OFEXTS	NP	OFEXTS
YOUSENIOR	NP	YOUSENIOR
SAID	VVD	say
THERE	EX	there
WOULD	MD	would
BE	VB	be
NO	DT	no
ERSATIONS	NP	ERSATIONS
AB	NP	AB
HOSTAGERAEL	NP	HOSTAGERAEL
STOEDKING	NP	STOEDKING
CON	VV	con
THE	DT	the
PHONE	NN	phone
WITH	IN	with
THEM	PP	them
AS	IN	as
THE	DT	the
S	NP	S
OF	IN	of
D	NP	D
BECOME	VV	become
I	PP	I
NTART	NP	NTART
WITH	IN	with
JIM.S	NP	JIM.S
HAMA	NP	Hama
EVEN	RB	even
NOW	RB	now
AFTERTHOUSAND	NP	AFTERTHOUSAND
STRIKES.	NP	STRIKES.
MANY	JJ	many
HAMASOMMAND	NP	HAMASOMMAND
TO	TO	to
ISRAELIS	NPS	Israelis
TAKEOUT.	NP	TAKEOUT.
THEY	PP	they
SAY	VVP	say
COME	VV	come
UPA	NP	UPA
T	NN	T
WHAT	WP	what
MORE	RBR	more
YT	NP	YT
ILIEND	NP	ILIEND
LEARLY	NP	LEARLY
STILL	RB	still
&gt;&gt;L	VVP	&gt;&gt;L
EXISTSE	NP	EXISTSE
UT	NP	UT
TUNNELS.	NP	TUNNELS.
LLIONS	NNS	LLIONS
OF	IN	of
DO	VVP	do
BS	NP	BS
E	NP	E
2008,	CD	@card@
SINCE	IN	since
TH	NN	th
E.	NP	E.
HAVE	VHP	have
NO	DT	no
SRTO	NP	SRTO
BUILD	VV	build
BECAUS	NP	BECAUS
THEM.NVEST	NP	THEM.NVEST
Y	NP	Y
BILLIONSY	NP	BILLIONSY
QATAR	NP	Qatar
EM	NN	em
GETE	NP	GETE
QO	NP	QO
GAZA,	NP	GAZA,
EA	NP	EA
ION	NN	ion
TO	TO	to
SITUATION,	NP	SITUATION,
HEY	UH	hey
BUILD	VV	build
TUNNELS	NNS	tunnel
AND	CC	and
THIS	DT	this
IS	VBZ	be
E	NP	E
A.AND	NP	A.AND
ALL	DT	all
TH	NN	th
Y	NP	Y
WHAE	NP	WHAE
TO	TO	to
BUILD	VV	build
TUN,	NP	TUN,
A	DT	a
PROJECT	NN	project
OF	IN	of
TUNNELS	NNS	tunnel
FOR	IN	for
MANY	JJ	many
YEARS.	NP	YEARS.
EVEN	RB	even
NOW	RB	now
THEY'RE	NP	THEY'RE
ABLTO	NP	ABLTO
USE	NN	use
&gt;&gt;	NN	&gt;&gt;
I	PP	I
TRY	VVP	try
TO	TO	to
SOUGAZA	NP	SOUGAZA
F	NP	F
MS	NN	Ms
I	PP	I
CAN	MD	can
AL	NP	al
TM	NP	TM
UNDERGROUND.	NP	UNDERGROUND.
O	NP	O
NOL.BACK	NP	NOL.BACK
TO	TO	to
E	NP	E
LANDLINE	NP	LANDLINE
S	NP	S
POINT	NN	point
ABOUT	IN	about
THESE	DT	these
TUNNELS.	NP	TUNNELS.
LWERE	NP	LWERE
RELSEE	NP	RELSEE
WHAT	WP	what
DO	VVP	do
YOU	PP	you
THINK	VVP	think
IS	VBZ	be
H	NP	H
MOH	NP	Moh
TH	NN	th
&gt;&gt;	NN	&gt;&gt;
AN	DT	an
ISRAELSO	NP	ISRAELSO
SAYAT	NP	SAYAT
WE	PP	we
ARE	VBP	be
CLOSEA	NP	CLOSEA
DEALI	NP	DEALI
MUSTAYHAMAS	NP	MUSTAYHAMAS
A	DT	a
LARGE	JJ	large
AMOUNT	NN	amount
O	NP	O
AND	NP	AND
FOR	IN	for
TWREASONY	NP	TWREASONY
O	NP	O
SHOW	VVP	show
THE	DT	the
PALESTINIAN-	NP	PALESTINIAN-
GAZATHAT	NP	GAZATHAT
D	NP	D
HEY'VE	NP	HEY'VE
NOTE	NN	note
HOST	VV	host
THEY	PP	they
ND	NN	ND
REA	NP	REA
OTHERWISE,	NP	OTHERWISE,
ISRAEL	NP	Israel
DETO	NP	DETO
GAZA.	NP	GAZA.
&gt;&gt;	NN	&gt;&gt;
KILLS	VVZ	kill
T	NN	T
KILL	VV	kill
OU	NP	Ou
EVEN	JJ	even
ISEL	NP	ISEL
S	NP	S
</doc>	NN	</doc>
