<video_id>RCxMyVIprCg</video_id>	NP	<video_id>RCxMyVIprCg</video_id>
<video_title>Samantha	NP	<video_title>Samantha
Power	NP	Power
describes	VVZ	describe
'devastating'	NP	'devastating'
humanitarian	JJ	humanitarian
situation	NN	situation
in	IN	in
Gaza</video_title>	NP	Gaza</video_title>
<thumbnail_path>data/en_CNN\Samantha	NP	<thumbnail_path>data/en_CNN\Samantha
Power	NP	Power
describes	VVZ	describe
'devastating'	NP	'devastating'
humanitarian	JJ	humanitarian
situation	NN	situation
in	IN	in
Gaza.jpg</thumbnail_path>	NP	Gaza.jpg</thumbnail_path>
<publish_date>20240614</publish_date>	NN	<publish_date>20240614</publish_date>
<doc>	NN	<doc>
IS	VBZ	be
&gt;&gt;	JJ	&gt;&gt;
NOWUMMIT	NP	NOWUMMIT
IN	IN	in
ITALY,	NP	ITALY,
PRESIDENT	NN	president
BIDEN	NP	Biden
T	NN	T
ON	IN	on
IMNT	NP	IMNT
CEASEFIRE	NN	ceasefire
IN	IN	in
STEN	NP	Sten
TO	TO	to
IS'ANE	NP	IS'ANE
ENDORSED	VVN	endorse
BY	IN	by
EC	NP	EC
UN	NP	UN
T	NN	T
ISRAELIS.	NP	ISRAELIS.
AND	CC	and
T	NN	T
HANG-UP	NN	hang-up
FAR	RB	far
IS	VBZ	be
HA	NP	ha
REFUSING	VVG	refuse
TO	TO	to
SIGN	VV	sign
ON,	NP	ON,
EVEN	RB	even
THOUGH	RB	though
THEY	PP	they
HAVE	VH	have
SUBMITTEDTHING	NP	SUBMITTEDTHING
HADN'T	NP	HADN'T
FRUITION,	NP	FRUITION,
REMAINS	VVZ	remain
INUE	NP	INUE
TO	TO	to
PUSH.	NP	PUSH.
I	NP	I
DON'T	NP	DON'T
HAVE	VHP	have
A	DT	a
FINE	JJ	fine
LINE	NN	line
ADMINISTRATOR,	NP	ADMINISTRATOR,
SAMANTHA	NP	Samantha
POWER	NN	power
AS	IN	as
MUNI	NNS	muni
MUCH	RB	much
IS	VBZ	be
E	NN	E
WITHOUT	IN	without
A	DT	a
ADMANITA	NP	ADMANITA
C'S	NP	C'S
ABS	NP	ABS
BE	VB	be
MORE	JJR	more
.	SENT	.
YOU	PP	you
HAVE	VHP	have
ABOUT	RB	about
95%	CD	@card@
OT	NN	ot
ACCESSEAN	JJ	ACCESSEAN
WATER	NN	water
IN	IN	in
MONTHSISITE	NP	MONTHSISITE
R	NP	R
BESTTS,	NP	BESTTS,
ONLY	JJ	only
9N	NN	9N
AVERAGE	NN	average
GOT	VVD	get
INTO	IN	into
DAY.	NP	DAY.
THAT'INOF	NP	THAT'INOF
THE	DT	the
FIGHTING	VVG	fight
IDF	NP	IDF
MILITARY	JJ	military
OPERATIONS,	NP	OPERATIONS,
HAFIMANG	NP	HAFIMANG
THE	DT	the
CIVILIAN	JJ	civilian
POPULATION	NN	population
BUT	CC	but
IT'ALSO,	NP	IT'ALSO,
IT	PP	it
EASEFI	NP	EASEFI
YOU	PP	you
WOULD	MD	would
ULCROSS,	NP	ULCROSS,
OPEN	VV	open
A	DT	a
FULL	JJ	full
FLOW	NN	flow
OASSISTANCE	NN	OASSISTANCE
GOING	VVG	go
OBILIT	NP	OBILIT
THAT	IN/that	that
WOU	NP	WOU
DISACAUSE	NP	DISACAUSE
ALMOST	RB	almost
THE	DT	the
SINCE	IN	since
OCTOBER	NP	October
7,	CD	@card@
TO	TO	to
BE	VB	be
ABLE	JJ	able
TO	TO	to
GET	VV	get
ACCESS	NN	access
TO	TO	to
FOO	NP	Foo
TOY	NN	toy
OF	IN	of
THEM	PP	them
ARE	VBP	be
N	NP	N
THE	DT	the
OPEN	JJ	open
AIR	NN	air
RATHER	RB	rather
THAN	IN	than
INTENSE.	NP	INTENSE.
AND	NP	AND
OF	IN	of
VITE	NP	Vite
DEELY	NP	DEELY
TO	TO	to
BE	VB	be
ABLE	JJ	able
TO	TO	to
SUPPORT	NP	SUPPORT
OUR	PP$	our
HUMANI	NP	HUMANI
PART	NN	part
W	NN	W
ARE	VBP	be
SUPPORTINGAZ	NP	SUPPORTINGAZ
ADMINISTRATOOUD	NP	ADMINISTRATOOUD
IN	IN	in
THE	DT	the
PAST	NN	past
THAT	IN/that	that
DELIVERING	VVG	deliver
AID	NN	aid
I	PP	I
CRITICALLY	RB	critically
IMPORTANT.	NP	IMPORTANT.
THE	NP	THE
PASTYOU	NP	PASTYOU
SAID	VVD	say
DELG	NP	DELG
AID	NN	aid
BY	IN	by
LAND	NN	land
IS	VBZ	be
YOUWOEVERNG	NP	YOUWOEVERNG
WHY	WRB	why
ISN'T	NP	ISN'T
USING	VVG	use
ALL	PDT	all
ITS	PP$	its
LEVERAO	NP	LEVERAO
GET	VVP	get
ISRAEL	NP	Israel
TO	TO	to
,	,	,
FORR	NP	FORR
PE	NN	pe
SPORADIC	JJ	sporadic
AIRDROPS	NNS	airdrop
WELL,	NP	WELL,
WE	PP	we
HAN	NP	han
STRATEGY,	NP	STRATEGY,
SAY,	NP	SAY,
WE	PP	we
VECO	NP	VECO
ARE	VBP	be
XIE	NP	Xie
G	NP	G
LEVERAGE	NN	leverage
WITH	IN	with
THE	DT	the
F	NP	F
ISRAEL.	NP	ISRAEL.
OBVIOUSLY	RB	obviously
YPIA	NP	YPIA
ON	NP	ON
RIT'S	NP	RIT'S
INCREDIBLY	RB	incredibly
IMPOR	NP	IMPOR
FHAOINT	NP	FHAOINT
I	NP	I
THE	NP	THE
EREZ	NP	EREZ
CROSSING	NN	crossing
BE	VB	be
USE	VV	use
OM	NP	Om
TRUCKSLA	NP	TRUCKSLA
IN	IN	in
TWO	CD	two
GAZA.	NP	GAZA.
S	NP	S
BE	VB	be
ABLE	JJ	able
THAT	IN/that	that
THEY	PP	they
NOT	RB	not
LOOTED.Y	NP	LOOTED.Y
BUT	CC	but
ALSER.	NP	ALSER.
THERE.	NP	THERE.
AND	CC	and
THE	DT	the
CONFLICT	NN	conflict
ITSELF	PP	itself
GETSN	NP	GETSN
OF	IN	of
HNG	NP	HNG
AB	NP	AB
THEIR	PP$	their
WORK	NN	work
TH	NN	th
ER	UH	er
CHALNGMAJOR	NP	CHALNGMAJOR
MEAN,	NP	MEAN,
THIS	DT	this
IS	VBZ	be
WHY	WRB	why
LAND	NN	land
IS	VBZ	be
OUR	PP$	our
FIRST	NP	FIRST
PRENE	NP	PRENE
RELIABLN	NP	RELIABLN
GET	VVP	get
PROPERT	NP	PROPERT
GOING	VVG	go
THROUGH	IN	through
THE	DT	the
MARITIME	JJ	maritime
PIER.	NP	PIER.
GOING	VVG	go
500,000	CD	@card@
PEOPLE	NNS	people
FOR	IN	for
A	DT	a
NTH.	NP	NTH.
SO	IN	so
THN	NP	THN
ADDITIVE	JJ	additive
PART	NN	part
OF	IN	of
THE	DT	the
SOLUTION,	NP	SOLUTION,
BUT	CC	but
FOUNDATIONAL	JJ	foundational
MEANS	NN	means
O	NN	O
GETTING	VVG	get
FOOD	NN	food
TO	TO	to
PEOPLE	NNS	people
IN	IN	in
GAZA	NP	Gaza
HAS	VHZ	have
GOT	VVN	get
TO	TO	to
BE	VB	be
BY	IN	by
THESE	DT	these
LAND	NN	land
CROSNG18SA	NP	CROSNG18SA
T	NN	T
W	NP	W
THE	DT	the
WHOLE	JJ	whole
HUMANITARIAN	JJ	humanitarian
COMMUNI	NP	COMMUNI
HN	NP	HN
CEB	NN	CEB
TINIEST	JJS	tiny
A	DT	a
COYOU	NP	COYOU
RESPOND	NN	respond
TOHA&gt;&gt;D	NP	TOHA&gt;&gt;D
HAVEN'BRATING	NP	HAVEN'BRATING
ANYTHING	NN	anything
WOLF.	NP	WOLF.
THT	NP	THT
THE	DT	the
FACT	NN	fact
THAT	WDT	that
YOVE	VVZ	YOVE
300	CD	@card@
AID	NN	aid
WORKERS	NNS	worker
WHO	WP	who
HAVE	VHP	have
BEEN	VBN	be
CONFLICT,	NP	CONFLICT,
MORE	RBR	more
JOURNALISLLED	VVD	JOURNALISLLED
THD	NP	THD
OFORE	NP	OFORE
THAN	IN	than
CIVILIANS,	NP	CIVILIANS,
MANY	JJ	many
WHOM	WP	whom
A	DT	a
N	NP	N
HAPPENING.N'INCREM	NP	HAPPENING.N'INCREM
RECOGNIZE	VVP	recognize
THAT	IN/that	that
ERE	IN	ere
NETOOL	NP	NETOOL
ANDAL	NP	Andal
US	NP	US
BRINGHAT	NP	BRINGHAT
CHANGE	NN	change
AF	NN	AF
MASSIVE	JJ	massive
S	NN	S
JUST	RB	just
ABOUT	IN	about
GNG	NP	GNG
ABOUT	RB	about
LIVES	VVZ	live
OFAFETY	NN	OFAFETY
WHICH	WDT	which
R	NP	R
LIVES	VVZ	live
F	NP	F
GAZA	NP	Gaza
HAVE	VHP	have
NOT	RB	not
ENJOYED	VVN	enjoy
FOR	IN	for
SOME	DT	some
TIME.	NP	TIME.
THERE'SOI	NP	THERE'SOI
THERE'T	NP	THERE'T
BEEN	VBN	be
A	DT	a
SINDA	NP	SINDA
IN	IN	in
MOR	NN	mor
MTHWAR	NP	MTHWAR
WHERE	WRB	where
THE	DT	the
BASIC	JJ	basic
SA	NP	SA
WEUT	NP	WEUT
AT	IN	at
LEAST	JJS	least
500	CD	@card@
TRUCKSO	NP	TRUCKSO
THE	NP	THE
UNITED	NP	UNITED
S,	NP	S,
HASIDE	NP	HASIDE
ZA	NP	ZA
NEEDORE	NP	NEEDORE
CROSSINGS	NNS	crossing
OPEN.	NP	OPEN.
MOREFI	NP	MOREFI
RAST	NP	Rast
THERE	RB	there
TO	TO	to
BE	VB	be
A	DT	a
C	NP	C
IMPORTAN,	NP	IMPORTAN,
MORAL	JJ	moral
HINGIN	NP	HINGIN
NEED	NN	need
AND	CC	and
AGAIN,	NP	AGAIN,
WE'VE	NP	WE'VE
MA	NN	ma
WERE	VBD	be
AT	IN	at
THE	DT	the
BEGINNING,	NP	BEGINNING,
BUTRE	NP	BUTRE
NO	DT	no
</doc>	NN	</doc>
