<video_id>9QlVX2XMtms</video_id>	JJ	<video_id>9QlVX2XMtms</video_id>
<video_title>See	NN	<video_title>See
Palestinian	JJ	Palestinian
man's	NN	man's
point	NN	point
of	IN	of
view	NN	view
while	IN	while
evacuating	VVG	evacuate
Gaza	NP	Gaza
City</video_title>	NP	City</video_title>
<thumbnail_path>data/en_CNN\See	NN	<thumbnail_path>data/en_CNN\See
Palestinian	JJ	Palestinian
man's	NN	man's
point	NN	point
of	IN	of
view	NN	view
while	IN	while
evacuating	VVG	evacuate
Gaza	NP	Gaza
City.jpg</thumbnail_path>	NP	City.jpg</thumbnail_path>
<publish_date>20231117</publish_date>	NN	<publish_date>20231117</publish_date>
<doc>	NN	<doc>
шәгәышәҽанысҵар	JJ	шәгәышәҽанысҵар
сҭахуп,	NP	сҭахуп,
абри	NN	абри
аҳасабырбаҿы	NN	аҳасабырбаҿы
ижәбо	NN	ижәбо
асахьақәа	NN	асахьақәа
рҟынтәи	NN	рҟынтәи
џьоукы	NN	џьоукы
графикала	NN	графикала
ишышьақәгылоу.	JJ	ишышьақәгылоу.
Џьомана	NN	Џьомана
Карадшех	NN	Карадшех
Газа	NN	Газа
ақалақь	NN	ақалақь
аҿы	NN	аҿы
иҟоу	NN	иҟоу
зегьы	NN	зегьы
рҿаԥхьа	NN	рҿаԥхьа
дыҟоуп.	JJ	дыҟоуп.
Ҩышықәса	NN	Ҩышықәса
зхыҵуа	NN	зхыҵуа
Уалид	NN	Уалид
иҭаацәараҿы	NN	иҭаацәараҿы
зегь	NN	зегь
реиҳа	NN	реиҳа
иуадаҩыз	NN	иуадаҩыз
аибашьра	NN	аибашьра
аҵх	NN	аҵх
DAYBREAK	NN	daybreak
ҳәа	NN	ҳәа
изышьҭоу	NN	изышьҭоу
ала	NN	ала
ихы	NN	ихы
мҩаԥигеит.	JJ	мҩаԥигеит.
Израильтәи	NN	Израильтәи
арратә	NN	арратә
ааԥхьарақәа	NN	ааԥхьарақәа
еиҿкааны	NN	еиҿкааны
иҟоуп.	JJ	иҟоуп.
Уара	NN	Уара
30	CD	@card@
минуҭ	NNS	минуҭ
умоуп	JJ	умоуп
адәылҵразы.	NP	адәылҵразы.
Ноиабр	NN	Ноиабр
10	CD	@card@
азы	NN	азы
шьыжьымҭан	NN	шьыжьымҭан
9:30	CD	@card@
рзы	NN	рзы
акәын.	JJ	акәын.
Аамҭалатәи	NN	Аамҭалатәи
абираҟ	NN	абираҟ
шкәакәақәа	JJ	шкәакәақәа
рыла,	NP	рыла,
арратә	NN	арратә
усзуҩцәа	NN	усзуҩцәа
ирҳәеит	NN	ирҳәеит
рҽааныркыларц.	JJ	рҽааныркыларц.
Аиҭаҵра	NN	Аиҭаҵра
рҽазыҟарҵоит.	JJ	рҽазыҟарҵоит.
Нас	NN	Нас
шәара	NN	шәара
шәзы,	NP	шәзы,
Салима,	NP	Салима,
Дана,	NP	Дана,
ахьӡқәагьы	JJ	ахьӡқәагьы
шәдырбарц	NN	шәдырбарц
азы	NN	азы
еиҭаҵуеит.	JJ	еиҭаҵуеит.
Ари	NN	Ари
саб	NN	саб
итәуп.	JJ	итәуп.
Сара	NN	Сара
сыҷкәын	NN	сыҷкәын
Ҳанан	NN	Ҳанан
заҵәык	NN	заҵәык
иоуп.	JJ	иоуп.
Аха	NN	Аха
шәара	NN	шәара
шәзы	NN	шәзы
уи	NN	уи
џьашьахәуп	JJ	џьашьахәуп
урҭ	NP	урҭ
ирго	NN	ирго
маҷк	NN	маҷк
ала.	NP	ала.
Урҭ	NP	Урҭ
еилымкаау	JJ	еилымкаау
аҭыԥ	NN	аҭыԥ
ахь	NN	ахь
идәықәлоит.	JJ	идәықәлоит.
Зны-зынла	NN	Зны-зынла
аныҟәара	NN	аныҟәара
рылшом.	NP	рылшом.
Урҭ	NP	Урҭ
аҳот-дог	NP	аҳот-дог
рфон.	NP	рфон.
Ажурналист	JJ	Ажурналист
Рами	NN	Рами
Абу-Џьамал	NN	Абу-Џьамал
иҭаацәеи	NN	иҭаацәеи
30-ҩык	JJ	30-ҩык
инареиҳаны	NN	инареиҳаны
ргәылацәеи	NN	ргәылацәеи
иареи	NN	иареи
мчыла	NN	мчыла
рыҩныҵҟа	NN	рыҩныҵҟа
ишыргоз	NN	ишыргоз
аҭыхрақәа	JJ	аҭыхрақәа
мҩаԥигоит,	NP	мҩаԥигоит,
иарӷьа	NN	иарӷьа
напаҿы	NN	напаҿы
иҭел	NN	иҭел
кны	NN	кны
,	,	,
егьи	JJ	егьи
иԥа	JJ	иԥа
Уалид.	JJ	Уалид.
Убри	NN	Убри
аҟынтә	NN	аҟынтә
иԥеи	NN	иԥеи
иареи	NN	иареи
францызшәала	NN	францызшәала
драцәажәоит,	NP	драцәажәоит,
иԥҳәыс	NP	иԥҳәыс
длыԥшаауеит.	NP	длыԥшаауеит.
Ааи,	NP	Ааи,
сара	NP	сара
сзыԥшу	NP	сзыԥшу
егьырҭ	NP	егьырҭ
зықәрахь	JJ	зықәрахь
инеихьоу	NN	инеихьоу
ҳгәылацәа	NN	ҳгәылацәа
срыхьӡарц	NN	срыхьӡарц
рцәыцәгьоуп.	JJ	рцәыцәгьоуп.
Гәыӷра	NN	Гәыӷра
рымаӡам.	JJ	рымаӡам.
Сара	NN	Сара
хьаас	NN	хьаас
исымам	NN	исымам
зегьы	NN	зегьы
згаз	NN	згаз
ԥштәыла	NN	ԥштәыла
иҟоу	NN	иҟоу
амаҭәахәқәа,	NP	амаҭәахәқәа,
ус	NP	ус
анакәха,	NP	анакәха,
иамоуп	NN	иамоуп
,	,	,
ус	JJ	ус
анакәха,	NP	анакәха,
иамазар	NN	иамазар
ауп	NN	ауп
Аа,	NP	Аа,
ааи.	NP	ааи.
Еснагь	JJ	Еснагь
ишәаҳауа	NN	ишәаҳауа
абжьы	NN	абжьы
Израильтәи	NN	Израильтәи
адронқәа	NN	адронқәа
роуп.	JJ	роуп.
Шықәсырацәала	NN	Шықәсырацәала
Газа	NN	Газа
асаундтрак	JJ	асаундтрак
ауп,	NP	ауп,
амҩаду	NN	амҩаду
анҭыҵ	NN	анҭыҵ
ианнеиуаз.	JJ	ианнеиуаз.
Рами	NN	Рами
игәыла	NN	игәыла
Абу	NN	Абу
Аҳмед	NN	Аҳмед
дибоит.	JJ	дибоит.
Акы	NN	Акы
ииашам.	JJ	ииашам.
Обама	NN	Обама
иеиԥш	NN	иеиԥш
иҟоу	NN	иҟоу
аԥсыӡкҩы	NN	аԥсыӡкҩы
ҳҭыԥантәи	NN	ҳҭыԥантәи
аӡы	NN	аӡы
аҩаӡара	JJ	аҩаӡара
шԥаҟало,	NP	шԥаҟало,
шаҟа	NN	шаҟа
илаҟәу	NN	илаҟәу
аӡы	JJ	аӡы
аҩаӡара,	NP	аҩаӡара,
шаҟа	NN	шаҟа
илаҟәыз	NN	илаҟәыз
аӡы	NN	аӡы
аҩаӡара,	NP	аҩаӡара,
зыхә	NP	зыхә
ҳараку,	NP	ҳараку,
игәрагоу	JJ	игәрагоу
аҩаӡараҿы.	JJ	аҩаӡараҿы.
Сара	NN	Сара
с-	NN	с-
оҳ	NP	оҳ
сымазар,	NP	сымазар,
лаҟәны	NP	лаҟәны
саахәоит.	NP	саахәоит.
Мап,	NP	Мап,
аидарацәгьа	JJ	аидарацәгьа
ыҟам.	JJ	ыҟам.
Аха	NN	Аха
сара	NN	сара
уи	NN	уи
ахкы	NN	ахкы
сакәӡам.	JJ	сакәӡам.
Ҳара	NN	Ҳара
ҳзы	JJ	ҳзы
акәым,	NP	акәым,
аха	NN	аха
ҳара	NN	ҳара
ҳзы	NN	ҳзы
акәым,	NP	акәым,
аха.	NP	аха.
Сара	NN	Сара
сԥара	NN	сԥара
шьҭысхуеит.	JJ	шьҭысхуеит.
Исымам.	JJ	Исымам.
Сара	NN	Сара
издырит	NN	издырит
уԥара	NN	уԥара
издыруа	NN	издыруа
абзиабара	NN	абзиабара
злоу.	JJ	злоу.
Ишәасҳәап	NN	Ишәасҳәап
ари	NN	ари
арена	NN	арена
ҳара	NN	ҳара
ҳзы	NN	ҳзы
ишышәыӡбо.	JJ	ишышәыӡбо.
Аҳмед	NN	Аҳмед
ихы	NN	ихы
еихсны	NN	еихсны
дыршьит.	NP	дыршьит.
Иара	NP	Иара
изыҟамҵеит.	NP	изыҟамҵеит.
Убома,	NP	Убома,
Сакко	NN	Сакко
еиҳарак	NN	еиҳарак
дыџьашьахәуп.	JJ	дыџьашьахәуп.
Акәакь	NN	Акәакь
аҿы.	NN	аҿы.
Даҽа	NN	Даҽа
ҩыџьа,	NP	ҩыџьа,
хаҵеи	NP	хаҵеи
ԥҳәыси,	NP	ԥҳәыси,
урҭгьы	JJ	урҭгьы
еихсит.	JJ	еихсит.
Агәыԥ	NN	Агәыԥ
амца	NN	амца
ацраҵаз	NN	ацраҵаз
еилкааӡам.	NP	еилкааӡам.
CNN	NP	CNN
ари	NN	ари
авидео	NN	авидео
геолокациа	JJ	геолокациа
ҟаҵаны,	NP	ҟаҵаны,
Газа	NN	Газа
ақалақь	NN	ақалақь
агәҭантәи	NN	агәҭантәи
ари	NN	ари
аԥсра	NN	аԥсра
зҵоу	NN	зҵоу
аныҟәара	NN	аныҟәара
ашьҭаҵара	NN	ашьҭаҵара
мҩаԥнагеит	NN	мҩаԥнагеит
.	SENT	.
Израильтәи	JJ	Израильтәи
арратә	JJ	арратә
еилазаарақәа	NN	еилазаарақәа
ари	NN	ари
ахҭыс	NN	ахҭыс
азы	NN	азы
адыррақәа	NN	адыррақәа
рзаҳҭеит	NN	рзаҳҭеит
,	,	,
аха	JJ	аха
урҭ	NP	урҭ
ҳкомментариқәа	NN	ҳкомментариқәа
рзы	NN	рзы
иҟаҳҵаз	NN	иҟаҳҵаз
аҳәарақәа	NN	аҳәарақәа
зынӡа	NN	зынӡа
рҭак	NN	рҭак
ҟарымҵеит	NN	ҟарымҵеит
Салам,	NP	Салам,
Рами.	NP	Рами.
Рами	JJ	Рами
ҳнаӡеит	NN	ҳнаӡеит
уажәы	NN	уажәы
Аҩадаҟа.	JJ	Аҩадаҟа.
Сара	NN	Сара
абри	NN	абри
ажәылараҿы	NN	ажәылараҿы
сҟоуп.	NP	сҟоуп.
Абраҟа	NP	Абраҟа
егьырҭ	NP	егьырҭ
реиԥш,	NP	реиԥш,
урҭгьы	NN	урҭгьы
рхала	NN	рхала
иҟан.	JJ	иҟан.
Шьыфа	NN	Шьыфа
ахәышәтәырҭаҿы	JJ	ахәышәтәырҭаҿы
инеит,	NP	инеит,
аха	NN	аха
аибашьрагьы	NN	аибашьрагьы
убасҵәҟьа	NN	убасҵәҟьа
иҟалеит.	NP	иҟалеит.
Ауаа,	NP	Ауаа,
лҳәоит	JJ	лҳәоит
лара.	NN	лара.
Егьи	NN	Егьи
агәыԥ	JJ	агәыԥ
алахәыла,	NP	алахәыла,
Газа	NN	Газа
зегьы	NN	зегьы
шаҳаҭс	NN	шаҳаҭс
иумоуп.	JJ	иумоуп.
иҽааникылошәа	NN	иҽааникылошәа
ҟаҵаны.	JJ	ҟаҵаны.
Сара	NN	Сара
еснагь	NN	еснагь
сҽазысшәон	JJ	сҽазысшәон
дымшәарц,	NP	дымшәарц,
насгьы	NN	насгьы
ҳакәша-мыкәша	NN	ҳакәша-мыкәша
иибо	NN	иибо
асирк	NN	асирк
ма	NN	ма
агәырҿыхагатә	NN	агәырҿыхагатә
парк	NN	парк
акәушәа	NN	акәушәа
игәы	NN	игәы
иаанагарц.	NP	иаанагарц.
Исыздыруам,	NP	Исыздыруам,
исылшазар.	NP	исылшазар.
Ахьымӡӷ	NP	Ахьымӡӷ
аныҟәараҵәҟьагьы,	NP	аныҟәараҵәҟьагьы,
аҽада	NP	аҽада
арахь,	NP	арахь,
аҽы	NN	аҽы
абрахь	NN	абрахь
иугоит.	JJ	иугоит.
Сара	NN	Сара
уи	NN	уи
иара	NN	иара
изы	NN	изы
арлахҿыхра	NN	арлахҿыхра
сҽазысшәон	NN	сҽазысшәон
.	SENT	.
Иалшома?	JJ	Иалшома?
Рами	NN	Рами
сиазҵаарызма,	NP	сиазҵаарызма,
аҭыхра	NP	аҭыхра
зиӡбаз?	NP	зиӡбаз?
Уахәаԥш,	NP	Уахәаԥш,
сара	JJ	сара
исҭахуп	NN	исҭахуп
ари	NN	ари
адунеи	NN	адунеи
аҟынӡа	JJ	аҟынӡа
инеирц,	NP	инеирц,
ҳара	NN	ҳара
ҳазҭагылоу	NN	ҳазҭагылоу
аиашамра	NN	аиашамра
рдырырц	NN	рдырырц
азы	JJ	азы
Урҭ	NP	Урҭ
иҟаҳҵо	NN	иҟаҳҵо
зегьы	NN	зегьы
агәыҩбара	NN	агәыҩбара
рызцәырыргоит.	NP	рызцәырыргоит.
Урҭ	NP	Урҭ
зегь	NN	зегь
рыла	NN	рыла
еиҳа	JJ	еиҳа
иӷәӷәоуп,	NP	иӷәӷәоуп,
арратә	NN	арратә
мацара	NN	мацара
акәымкәа,	NP	акәымкәа,
иҭыҵуа	NP	иҭыҵуа
аинформациа	NP	аинформациа
ала.	NP	ала.
Иҭыҵуа	NP	Иҭыҵуа
ажәабжь,	NP	ажәабжь,
иҭыҵуа	NP	иҭыҵуа
ажәабжь,	NP	ажәабжь,
урҭ	NP	урҭ
ирҳәо	NP	ирҳәо
аиаша	NP	аиаша
ауп,	NP	ауп,
ҳара	JJ	ҳара
ҳажәақәа	NN	ҳажәақәа
амц	NN	амц
ауп.	NP	ауп.
Иагьырҳәеит,	NP	Иагьырҳәеит,
ҳәарада,	NP	ҳәарада,
адиджитал	NP	адиджитал
ахь.	NP	ахь.
Ҳаҳәоит,	NP	Ҳаҳәоит,
ҳажәабжь	JJ	ҳажәабжь
нага.	JJ	нага.
Уаҳа	NN	Уаҳа
акгьы	NN	акгьы
сҭахым.	JJ	сҭахым.
Иршьыз	NN	Иршьыз
зегьы	NN	зегьы
баша	NN	баша
иԥсызар	NN	иԥсызар
сҭахым.	JJ	сҭахым.
Уара	NN	Уара
Рами	JJ	Рами
иузыҟаҵозҭгьы,	NP	иузыҟаҵозҭгьы,
уажәы	NN	уажәы
иҟарҵо	NN	иҟарҵо
издыруам.	JJ	издыруам.
Аха	NN	Аха
иҳәоит	NN	иҳәоит
иԥсадгьыл	NN	иԥсадгьыл
аанрыжьуеит	NN	аанрыжьуеит
мчыла	NN	мчыла
шьапыла	NN	шьапыла
мамзаргьы	NN	мамзаргьы
дыԥсны	NN	дыԥсны
мацара.	JJ	мацара.
Ҳабиб	NN	Ҳабиб
ареволвер	NN	ареволвер
сымазарц	NN	сымазарц
иҭахымызҭгьы	NN	иҭахымызҭгьы
ҟаларын	NN	ҟаларын
Ерин	NN	Ерин
Израиль	JJ	Израиль
иазгәалҭеит,	NP	иазгәалҭеит,
ауаа	NN	ауаа
ааԥхьара	NN	ааԥхьара
ҟарҵоит	NN	ҟарҵоит
арратә	NN	арратә
усмҩаԥгатәқәа	NN	усмҩаԥгатәқәа
ахьымҩаԥысуа	NN	ахьымҩаԥысуа
аҭыԥқәа	JJ	аҭыԥқәа
аанрыжьырц,	NP	аанрыжьырц,
атәылауаа	NN	атәылауаа
рыԥсрақәа	NN	рыԥсрақәа
рырмаҷразы.	JJ	рырмаҷразы.
Аха	NN	Аха
ишышәдыруа	JJ	ишышәдыруа
еиԥш,	NP	еиԥш,
ООН	NN	ООН
иаҳәоит	NN	иаҳәоит
Газа	NN	Газа
џьаргьы	NN	џьаргьы
ашәарҭадара	NN	ашәарҭадара
ыҟам	JJ	ыҟам
ҳәа,	NP	ҳәа,
насгьы	NN	насгьы
адунеи	NN	адунеи
зегьы	NN	зегьы
аҿы	NN	аҿы
акритика	NN	акритика
ҟаҵоуп	NN	ҟаҵоуп
Газа	NN	Газа
иҭахаз	NN	иҭахаз
рхыԥхьаӡара	NN	рхыԥхьаӡара
11,400	CD	@card@
инареиҳаны	NN	инареиҳаны
иҟалеит	NN	иҟалеит
,	,	,
урҭ	NP	урҭ
рҟынтә	NP	рҟынтә
4700	CD	@card@
ахәыҷқәа	NN	ахәыҷқәа
роуп.	JJ	роуп.
Ари	NN	Ари
атәы	NN	атәы
аанацҳауеит	NN	аанацҳауеит
Палестина	NN	Палестина
агәабзиарахьчара	NN	агәабзиарахьчара
Аминистрра,	NP	Аминистрра,
урҭ	NP	урҭ
рхыԥхьаӡарақәа	JJ	рхыԥхьаӡарақәа
Ҳамас	NN	Ҳамас
инапаҵаҟа	NN	инапаҵаҟа
иҟоу	NN	иҟоу
анклав	NN	анклав
аҟынтәи	NN	аҟынтәи
иаагоуп.	NP	иаагоуп.
Ерин,	NP	Ерин,
ари	NN	ари
ҭаацәарак	NN	ҭаацәарак
рҭоурыхуп,	NP	рҭоурыхуп,
урҭ	NP	урҭ
рацәаҩны	NP	рацәаҩны
ирхыргоит,	NP	ирхыргоит,
аха	NP	аха
ҳара	NP	ҳара
урҭ	NP	урҭ
рҭоурыхқәа	JJ	рҭоурыхқәа
ҳзеиҭаҳәартә	NN	ҳзеиҭаҳәартә
алшара	NN	алшара
ҳамам.	JJ	ҳамам.
Ари	NN	Ари
аҭаацәаратә	NN	аҭаацәаратә
ҭаацәара	NN	ҭаацәара
ҩадаҟатәи	NN	ҩадаҟатәи
рныҟәара	NN	рныҟәара
хьанҭа	NN	хьанҭа
ҭырхуан.	JJ	ҭырхуан.
</doc>	NN	</doc>
