<video_id>rFl2AuVhbMM</video_id>	JJ	<video_id>rFl2AuVhbMM</video_id>
<video_title>Tapper:	JJ	<video_title>Tapper:
Key	JJ	Key
members	NNS	member
of	IN	of
Netanyahu’s	NP	Netanyahu’s
cabinet	NN	cabinet
‘throwing	NN	‘throwing
fire	NN	fire
on	IN	on
the	DT	the
flames’</video_title>	JJ	flames’</video_title>
<thumbnail_path>data/en_CNN\Tapper	NN	<thumbnail_path>data/en_CNN\Tapper
Key	JJ	Key
members	NNS	member
of	IN	of
Netanyahu’s	NP	Netanyahu’s
cabinet	NN	cabinet
‘throwing	NN	‘throwing
fire	NN	fire
on	IN	on
the	DT	the
flames’.jpg</thumbnail_path>	JJ	flames’.jpg</thumbnail_path>
<publish_date>20231116</publish_date>	NN	<publish_date>20231116</publish_date>
<doc>	NN	<doc>
W	NP	W
VIDETODAY	NP	VIDETODAY
S	NP	S
TO	TO	to
SHOW	VV	show
EL'SRAGAZA'S	NPS	EL'SRAGAZA'S
LARGEST	JJS	large
HOSPITAL.	NP	HOSPITAL.
N	NP	N
SEE	VV	see
MEDICS	NNS	medic
STILLIDTAS	NP	STILLIDTAS
DUST	NN	dust
SRO	NN	SRO
HIDING	NN	hiding
IS	VBZ	be
UNDEENON	NP	UNDEENON
HOALEX.	NP	HOALEX.
TERRORISTS	NNS	terrorist
AND	CC	and
STASHEDEIR	NP	STASHEDEIR
WEAPOO	NP	WEAPOO
THESE	DT	these
ARE	VBP	be
THLY	JJ	THLY
--	:	--
T	NN	T
INDEPEENTHE	NP	INDEPEENTHE
CONTENTSNOT	NP	CONTENTSNOT
ON	NP	ON
T	NN	T
ND.	NP	ND.
HOSPITAL	NN	hospital
OFFICIALS	NNS	official
N	NP	N
THIS&gt;&gt;	NP	THIS&gt;&gt;
WHAT	WP	what
IS	VBZ	be
CLEAR	JJ	clear
IN	IN	in
TAL	NP	Tal
ARE	VBP	be
HORRENDOUS,	NP	HORRENDOUS,
DOCTORS	NNS	doctor
ARE	VBP	be
TRYING	VVG	try
TKE	NP	TKE
HOSP	NP	Hosp
R.	NP	R.
ARE	VBP	be
RUNNGUPPLIES,	NP	RUNNGUPPLIES,
NOTRE	NP	Notre
REPORTS	VVZ	report
F.VEN	NP	F.VEN
THCIVILIAN	NP	THCIVILIAN
O	NP	O
ANY	DT	any
HOSTAGESERARLIERK	NP	HOSTAGESERARLIERK
FOR	IN	for
BE	VB	be
DOING	VVG	do
REGARDING	VVG	regard
THINGS	NNS	thing
WE	PP	we
CALAY	NP	CALAY
DOWN	RB	down
VERY	RB	very
VERY	JJ	very
T	NN	T
IS	VBZ	be
THR	NP	THR
A	DT	a
TWO-STATE	NN	two-state
SOLUTION&gt;&gt;	NP	SOLUTION&gt;&gt;
POI	NN	poi
IPOWI	NP	IPOWI
FLAMES	NNS	flame
IN	IN	in
THL.	NP	THL.
IN	IN	in
--	:	--
ONDA.COLUMNIST	NP	ONDA.COLUMNIST
S	NP	S
CABINKIGEHAMAS	NP	CABINKIGEHAMAS
S,	NP	S,
TAKING	VVG	take
AGDVANCE	NP	AGDVANCE
THEIR	PP$	their
RACISTB	NP	RACISTB
ENIN	NP	ENIN
THEES,	NP	THEES,
SUGGESTED	VVD	suggest
WEOULD.	NP	WEOULD.
MINISTER	NN	minister
IS	VBZ	be
A	DT	a
LITTLE	JJ	little
SMALL	NP	SMALL
POLITICIAN-T	NP	POLITICIAN-T
E	NP	E
ANNIANS	NP	ANNIANS
TH	NN	th
HAVEKILLED	VVN	HAVEKILLED
IN	IN	in
CLASHES	NNS	clash
S	NP	S
THE	NP	THE
WEST	IN	west
VES	NP	VES
WITHDRAWIN	NP	WITHDRAWIN
WAS	VBD	be
ARREEDNDNG	NP	ARREEDNDNG
TERRORIST	JJ	terrorist
ATTACK.	NP	ATTACK.
BY	IN	by
THE	DT	the
--	:	--
FOR	IN	for
WEEKS.	NP	WEEKS.
THAT	WDT	that
IS	VBZ	be
ACCORDING	VVG	accord
TO	TO	to
--	:	--
CAA,	NP	CAA,
WHAT,ISH	NP	WHAT,ISH
TERRORIST.	NP	TERRORIST.
THEY	PP	they
DENY	VVP	deny
THOSE	DT	those
CLAIMSSTATED	JJ	CLAIMSSTATED
THS	JJ	ths
L'S	NP	L'S
FRG	NP	FRG
E	NP	E
WAS	VBD	be
FREE	JJ	free
ANAGAINST	NP	ANAGAINST
HIM.	NP	HIM.
ON	NP	ON
MONDAY	NP	Monday
OFFR	NP	OFFR
T	NN	T
HE	PP	he
SS	NP	SS
THAT	WDT	that
HAS	VHZ	have
LLEN	NP	LLEN
THE-	NP	THE-
PLUNDETHE	NP	PLUNDETHE
WEST	IN	west
BK.MESSTOEIAN	NP	BK.MESSTOEIAN
PUR	NP	PUR
AS	NP	AS
WITTHE	NP	WITTHE
EDOTS,	NP	EDOTS,
EXTREMISTS,	NP	EXTREMISTS,
WE	PP	we
HAVE	VHP	have
IT	PP	it
IN	IN	in
THE	DT	the
WEST	JJ	west
BANK.	NP	BANK.
QUMMEDIATELY	NP	QUMMEDIATELY
UPON	IN	upon
HEARING	NN	hearing
OF	IN	of
THE	DT	the
CNAEN-GVIR	NP	CNAEN-GVIR
O	NP	O
ARAJEWISH	NP	ARAJEWISH
RTS	NP	RTS
IN	IN	in
ORDER	NN	order
TO	TO	to
DEVWHS	NP	DEVWHS
LEFT	VVN	leave
OF	IN	of
BEN-GVIR.LITIASACY,	NP	BEN-GVIR.LITIASACY,
WANDERING	VVG	wander
THE	DT	the
STREETS	NNS	street
OFAVE	NP	OFAVE
THEE	PP	thee
RA	NP	RA
ARM.NG	NP	ARM.NG
CIVICS	NNS	civics
TEAER	NP	TEAER
AND	NP	AND
FOR	IN	for
SHOWCOINIATE.	NP	SHOWCOINIATE.
,	,	,
TS,	NP	TS,
HE	PP	he
WR,	NP	WR,
ISRAELARAB	NP	ISRAELARAB
CITIZENN	NP	CITIZENN
AND	CC	and
ARREST	NN	arrest
MA	NN	ma
SPILLED	VVD	spill
SO	RB	so
WHAT	WP	what
IS	VBZ	be
LEFT	VVN	leave
OF	IN	of
IT.	NP	IT.
AROUNDG	NP	AROUNDG
--	:	--
HEAEREAM	NP	HEAEREAM
A	NP	A
SPECTACLEUNQUOTE.	NP	SPECTACLEUNQUOTE.
TERRORTSNG	NP	TERRORTSNG
BEN-GVI	NP	BEN-GVI
THIBRAGGINGUW	NP	THIBRAGGINGUW
EIGHT	CD	eight
NDCUFFED	NP	NDCUFFED
TER,	NP	TER,
TOILET	NN	toilet
FLOO.	NP	FLOO.
LIS	NP	Lis
--	:	--
TOGVIR,	NP	TOGVIR,
QUOTE,	NP	QUOTE,
,	,	,
I	PP	I
AM	VBP	be
BEGGING,	NP	BEGGING,
MY	PP$	my
C	NN	C
IS	VBZ	be
HAMAS,	NP	HAMAS,
AS	NP	AS
MIAT	NP	MIAT
BURNS	VVZ	burn
THEOF	JJ	THEOF
OUR	PP$	our
E	NP	E
E,	NP	E,
PLEASE	VVP	please
BUT	CC	but
THINKINGBO	NP	THINKINGBO
SUCH	JJ	such
THINGS	NNS	thing
NOT	RB	not
REALLY	RB	really
SEEM	VV	seem
TO	TO	to
BEN-GVIR	NP	BEN-GVIR
WA.	NP	WA.
JOINED	VVD	join
WITH	IN	with
TWO	CD	two
FOAL	NN	foal
MASSACR	NP	MASSACR
2015,AT	NP	2015,AT
QUOTE,	NP	QUOTE,
WEDDINGF	NP	WEDDINGF
ERLESTINIANSWEST	NP	ERLESTINIANSWEST
BAN	NN	ban
E	NN	E
OF	IN	of
A	DT	a
.	SENT	.
ITT	NP	ITT
SEEMS	VVZ	seem
E	NP	E
EXTREMIS	NP	extremis
DN.VERNM&gt;&gt;	NP	DN.VERNM&gt;&gt;
YOU	PP	you
HAVE	VHP	have
A	DT	a
MALS,	NP	MALS,
CONR	NP	CONR
E.	NP	E.
HE	PP	he
ALLED	NP	ALLED
HIEL	NP	HIEL
-SEX	NN	-SEX
MARRIAGES	NNS	marriage
SATO	NP	Sato
INCESOR	NP	INCESOR
ON.N	NP	ON.N
THE	NP	THE
GAZA	NP	Gaza
BULLAS	NP	Bullas
THAY	NP	Thay
HE	PP	he
WAS	VBD	be
SAYING	VVG	say
WATTING	NP	WATTING
OUT	IN	out
THESE	DT	these
YOU	PP	you
MUST	MD	must
HAVE	VH	have
SEEN	VVN	see
THI	NP	Thi
OUINI	NP	OUINI
MEAN,	NP	MEAN,
THESDIVIDUALS.	NP	THESDIVIDUALS.
AAR	NP	AAR
PVES	NP	PVES
WHEN	WRB	when
THEY	PP	they
GET	VVP	get
P	NN	P
IAINLY	NP	IAINLY
THE	NP	THE
CASE	NN	case
HERE.	NP	HERE.
IBLE	NP	IBLE
POLICIES	NNS	policy
AND	CC	and
THECISIE	NP	THECISIE
T	NN	T
THEY	PP	they
DO	VVP	do
POWER,AND	NP	POWER,AND
IF'S	NP	IF'S
HANTHE	NP	HANTHE
WHEEL,R	NP	WHEEL,R
S	NP	S
TOCOTHELHEBINET	NP	TOCOTHELHEBINET
MINIERE	NP	Miniere
ITE	JJ	ITE
</doc>	NN	</doc>
