<	SYM	<
video_id	NN	video_id
>	SYM	>
I5yAK7kt0os	NP	I5yAK7kt0os
<	SYM	<
/	SYM	/
video_id	NN	video_id
>	SYM	>
<	SYM	<
video_title	NN	video_title
>	SYM	>
Video	NP	Video
shows	NNS	show
journey	NN	journey
one	CD	one
woman	NN	woman
took	VVD	take
to	TO	to
escape	VV	escape
shooting	VVG	shoot
at	IN	at
music	NN	music
festival	NN	festival
<	SYM	<
/	SYM	/
video_title	NN	video_title
>	SYM	>
<	SYM	<
thumbnail_path	NN	thumbnail_path
>	SYM	>
data	NNS	datum
/	SYM	/
en_CNN	NP	en_CNN
\	SYM	\
Video	NP	Video
shows	NNS	show
journey	NN	journey
one	CD	one
woman	NN	woman
took	VVD	take
to	TO	to
escape	VV	escape
shooting	VVG	shoot
at	IN	at
music	NN	music
festival	NN	festival
.	SENT	.
jpg	NN	jpg
<	SYM	<
/	SYM	/
thumbnail_path	NN	thumbnail_path
>	SYM	>
<	SYM	<
publish_date	NN	publish_date
>	SYM	>
20231010	CD	@card@
<	SYM	<
/	SYM	/
publish_date	NN	publish_date
>	SYM	>
<	SYM	<
doc	NN	doc
>	SYM	>
Уи	JJ	Уи
аҟынтә	NN	аҟынтә
.	SENT	.
Лара	JJ	Лара
сышьҭахь	NN	сышьҭахь
дтәан	NN	дтәан
,	,	,
иҳәа	JJ	иҳәа
,	,	,
ахаангьы	JJ	ахаангьы
уи	JJ	уи
сҳәарц	NN	сҳәарц
сҭахымызт	NN	сҭахымызт
.	SENT	.
Ари	JJ	Ари
сара	NN	сара
исыздыруам	NN	исыздыруам
.	SENT	.
Уи	JJ	Уи
џьашьахәуп	NN	џьашьахәуп
.	SENT	.
Уи	JJ	Уи
џьашьахәуп	NN	џьашьахәуп
.	SENT	.
Аџьашьахәы	JJ	Аџьашьахәы
,	,	,
избан	JJ	избан
акәзар	JJ	акәзар
сааигәара	NN	сааигәара
иҟаз	NN	иҟаз
ауаа	NN	ауаа
лшьапы	NN	лшьапы
ахәымпал	NN	ахәымпал
ҭаҵаны	NN	ҭаҵаны
,	,	,
лымгәаҿы	JJ	лымгәаҿы
аԥҽыхақәа	JJ	аԥҽыхақәа
ҭаны	NN	ҭаны
рыԥсы	NN	рыԥсы
ҭаны	NN	ҭаны
иҭымҵӡеит	NN	иҭымҵӡеит
.	SENT	.
27	CD	@card@
шықәса	JJ	шықәса
зхыҵуа	JJ	зхыҵуа
Маикл	NN	Маикл
Оҳана	NN	Оҳана
ақәҿиара	NN	ақәҿиара
змоу	NN	змоу
дыруаӡәкны	NN	дыруаӡәкны
лхы	NN	лхы
лԥхьаӡоит	NN	лԥхьаӡоит
.	SENT	.
Аха	JJ	Аха
Израиль	JJ	Израиль
аҩадатәи	NN	аҩадатәи
ахәҭаҿы	NN	ахәҭаҿы
имҩаԥысуаз	NN	имҩаԥысуаз
Новатәи	NN	Новатәи
амузыкатә	NN	амузыкатә
фестиваль	NN	фестиваль
аҿы	NN	аҿы
аракетақәа	NN	аракетақәа
рыбжьы	NN	рыбжьы
анга	NN	анга
,	,	,
Ҳамас	JJ	Ҳамас
ақәылацәа	JJ	ақәылацәа
шәҩыла	NN	шәҩыла
афестиваль	NN	афестиваль
ахь	NN	ахь
инеиуаз	NN	инеиуаз
ршьра	NN	ршьра
,	,	,
рыӷьычра	JJ	рыӷьычра
ианалага	NN	ианалага
,	,	,
Николс	JJ	Николс
иԥеиԥш	JJ	иԥеиԥш
зынӡа	NN	зынӡа
иҭынчмызт	NN	иҭынчмызт
.	SENT	.
Сара	JJ	Сара
издыруан	JJ	издыруан
ванла	NN	ванла
ҳшықәиҵоз	NN	ҳшықәиҵоз
.	SENT	.
Ахысырҭа	JJ	Ахысырҭа
мацара	NN	мацара
акәын	NN	акәын
,	,	,
ахысра	NN	ахысра
.	SENT	.
Уи	JJ	Уи
зылшоз	NN	зылшоз
дыҩит	NN	дыҩит
.	SENT	.
Анаҩс	JJ	Анаҩс
егьырҭгьы	NN	егьырҭгьы
ршьит	NN	ршьит
.	SENT	.
Амашьына	JJ	Амашьына
аԥенџьырқәа	JJ	аԥенџьырқәа
ахәымпалқәа	NN	ахәымпалқәа
анҭала	NN	анҭала
ашьҭахь	NN	ашьҭахь
лхаҵеи	NN	лхаҵеи
лареи	NN	лареи
рыҽрыцәырыхьчарц	NN	рыҽрыцәырыхьчарц
рҽазыршәон	NN	рҽазыршәон
.	SENT	.
Иаарласны	JJ	Иаарласны
Маикл	NN	Маикл
50	CD	@card@
-	NN	-
ҩык	NN	ҩык
раҟара	NN	раҟара
ауаа	NN	ауаа
ӡааҟәрыланы	NN	ӡааҟәрыланы
иахьыҟаз	NN	иахьыҟаз
ашҭа	NN	ашҭа
хәыҷы	NN	хәыҷы
аҿы	NN	аҿы
аҽыҵәахырҭа	NN	аҽыҵәахырҭа
иԥшааит	NN	иԥшааит
Уажәнатә	NN	Уажәнатә
ауаа	NN	ауаа
рыхәрақәа	NN	рыхәрақәа
ыҟан	NN	ыҟан
,	,	,
џьоукы	JJ	џьоукы
ршьапқәа	JJ	ршьапқәа
рҿы	NN	рҿы
,	,	,
џьоукы	JJ	џьоукы
рыбӷа	NN	рыбӷа
,	,	,
џьоукы	JJ	џьоукы
рыхқәа	JJ	рыхқәа
рҿы	NN	рҿы
.	SENT	.
Сара	JJ	Сара
акәырша	JJ	акәырша
схаҵаны	NN	схаҵаны
сыҟан	NN	сыҟан
,	,	,
сааигәара	JJ	сааигәара
аӡәы	JJ	аӡәы
ишьа	NN	ишьа
леиуан	NN	леиуан
,	,	,
убри	JJ	убри
аҟнытә	JJ	аҟнытә
лшьапы	NN	лшьапы
атурникет	NN	атурникет
лысҭеит	NN	лысҭеит
.	SENT	.
Минуҭқәак	JJ	Минуҭқәак
рышьҭахь	JJ	рышьҭахь
ахысбыжьқәа	NN	ахысбыжьқәа
геит	NN	геит
.	SENT	.
Босниа	NN	Босниа
.	SENT	.
Ирҵыс	NN	Ирҵыс
.	SENT	.
Минуҭқәак	JJ	Минуҭқәак
ҭынчран	NN	ҭынчран
.	SENT	.
Уаҟа	JJ	Уаҟа
Аԥсы	JJ	Аԥсы
ҭазарц	NN	ҭазарц
зҭахыз	NN	зҭахыз
уажәы	NN	уажәы
ацара	NN	ацара
ихәҭоуп	NN	ихәҭоуп
.	SENT	.
Зымцаз	JJ	Зымцаз
цеит	NN	цеит
.	SENT	.
Излымшаз	NN	Излымшаз
.	SENT	.
Урҭ	NP	Урҭ
ирыхьыз	NN	ирыхьыз
сыздыруам	NN	сыздыруам
.	SENT	.
Маикл	JJ	Маикл
лхаҵеи	JJ	лхаҵеи
лареи	NN	лареи
еибарыҩны	NN	еибарыҩны
идәықәлеит	NN	идәықәлеит
,	,	,
аха	JJ	аха
Маикл	JJ	Маикл
лшьапқәа	NN	лшьапқәа
ахьеиҵаҟәаҟәаз	NN	ахьеиҵаҟәаҟәаз
азы	NN	азы
дшәеит	NN	дшәеит
.	SENT	.
Лҩыза	JJ	Лҩыза
аҷкәын	JJ	аҷкәын
дҳәазаны	NN	дҳәазаны
дгьыл	NN	дгьыл
дықәиҵеит	NN	дықәиҵеит
,	,	,
насгьы	JJ	насгьы
Аха	JJ	Аха
еснагь	NN	еснагь
Ҳамас	NN	Ҳамас
аибашьцәа	NN	аибашьцәа
шәара	NN	шәара
шәахь	NN	шәахь
инеит	NN	инеит
.	SENT	.
Урҭ	NP	Урҭ
зегьы	NP	зегьы
пикап	JJ	пикап
шкәакәақәа	NN	шкәакәақәа
рыла	NN	рыла
ицон	NN	ицон
.	SENT	.
Ҩажәаҩык	JJ	Ҩажәаҩык
раҟара	JJ	раҟара
атеррористцәа	NN	атеррористцәа
ыҟан	NN	ыҟан
,	,	,
Калашников	JJ	Калашников
игранатқәа	NN	игранатқәа
,	,	,
ашәақьқәа	JJ	ашәақьқәа
,	,	,
апулемиотқәа	JJ	апулемиотқәа
зкыз	NN	зкыз
.	SENT	.
Сара	JJ	Сара
сыԥсҭазаараҿы	JJ	сыԥсҭазаараҿы
ас	NN	ас
еиԥш	NN	еиԥш
акгьы	NN	акгьы
сымбацызт	NN	сымбацызт
Иаарыкәыршаны	NN	Иаарыкәыршаны
иҟазшәа	NN	иҟазшәа
,	,	,
Николь	JJ	Николь
ҩаԥхьа	JJ	ҩаԥхьа
амашьына	NN	амашьына
дҭыҵны	NN	дҭыҵны
дыҩуа	NN	дыҩуа
далагеит	NN	далагеит
,	,	,
Ахҭырԥақәа	JJ	Ахҭырԥақәа
уахьгьы	JJ	уахьгьы
инаӡеит	NN	инаӡеит
,	,	,
атанк	JJ	атанк
аҵаҟа	JJ	аҵаҟа
рҽыҵәахны	NN	рҽыҵәахны
.	SENT	.
Маикл	JJ	Маикл
ишьапы	JJ	ишьапы
еихсны	NN	еихсны
дҭаркит	NN	дҭаркит
,	,	,
насгьы	JJ	насгьы
аграната	JJ	аграната
аԥҽыхақәа	NN	аԥҽыхақәа
лымгәа	NN	лымгәа
иҭаҳаит	NN	иҭаҳаит
Уи	NN	Уи
аамҭазы	NN	аамҭазы
,	,	,
ҳара	JJ	ҳара
иаҳбаӡомызт	NN	иаҳбаӡомызт
.	SENT	.
Акгьы	JJ	Акгьы
ҳбомызт	NN	ҳбомызт
.	SENT	.
Урҭгьы	JJ	Урҭгьы
ргеит	NN	ргеит
.	SENT	.
Џьоукы	JJ	Џьоукы
ргеит	NN	ргеит
.	SENT	.
Аха	JJ	Аха
даҽа	JJ	даҽа
бжьы	NN	бжьы
сааҭк	NN	сааҭк
рыҩныҵҟа	NN	рыҩныҵҟа
Израильтәи	NN	Израильтәи
аруаа	NN	аруаа
леиқәдырхаанӡа	NN	леиқәдырхаанӡа
.	SENT	.
Ан	JJ	Ан
лара	JJ	лара
Ҳадасса	NN	Ҳадасса
ахәышәтәырҭахь	NN	ахәышәтәырҭахь
днаргеит	NN	днаргеит
,	,	,
уаҟа	NN	уаҟа
60	CD	@card@
-	NN	-
ҩык	NN	ҩык
инареиҳаны	NN	инареиҳаны
ахәышәтәра	NN	ахәышәтәра
зыхьыз	NN	зыхьыз
дыруаӡәкын	NN	дыруаӡәкын
.	SENT	.
Сара	JJ	Сара
сԥа	NN	сԥа
сихәаԥшуеит	NN	сихәаԥшуеит
,	,	,
насгьы	JJ	насгьы
сгәы	JJ	сгәы
иаанагоит	NN	иаанагоит
уи	NN	уи
ҟасҵоит	NN	ҟасҵоит
ҳәа	NN	ҳәа
.	SENT	.
Угәы	JJ	Угәы
иаанагон	JJ	иаанагон
уԥсуеит	NN	уԥсуеит
ҳәа	NN	ҳәа
?	SENT	?
Ааи	NN	Ааи
.	SENT	.
<	SYM	<
/	SYM	/
doc	NN	doc
>	SYM	>
